FIPS,COUNTY,POP_TOT,MALE_POP,FEMALE_POP,GDP,DEGREE_TOT,BACHELOR,MASTER,PROFFE,DOCTOR,TOT_NO_INS,MALE_INS,FEMALE_INS,BOTH_INS,TOT_POV,MALE_POV,FEMALE_POV,TOT_COMM,OTHER_COMM,REPORTED_IMPORTS
01001,"Autauga County, Alabama",58761,28663,30098,35332,40188,6726,4014,702,437,57443,2240,1985,4225,6630,2914,3716,27031,76,NA
01003,"Baldwin County, Alabama",233420,114077,119343,38907,167022,33474,15077,3483,2351,230074,11172,10300,21472,23445,9819,13626,105865,1030,NA
01005,"Barbour County, Alabama",24877,12973,11904,23378,17675,1167,640,188,105,21892,1157,1191,2348,5280,2023,3257,8341,54,NA
01007,"Bibb County, Alabama",22251,11897,10354,24966,15925,1047,507,109,76,20850,1035,725,1760,4297,2307,1990,8064,28,NA
01009,"Blount County, Alabama",59077,29864,29213,29053,40817,3840,1751,270,156,58587,3257,2691,5948,8277,3624,4653,24402,124,NA
01011,"Bullock County, Alabama",10328,5542,4786,22115,7156,492,93,53,33,9640,594,582,1176,2687,1277,1410,3679,56,NA
01013,"Butler County, Alabama",18981,8928,10053,26334,13266,1029,542,139,21,18686,905,1148,2053,3937,1458,2479,7394,81,NA
01015,"Calhoun County, Alabama",116162,56185,59977,28227,78931,9098,4121,888,1011,114576,6838,5592,12430,20267,8375,11892,48898,187,NA
01017,"Chambers County, Alabama",34612,16485,18127,27006,24706,2273,737,81,55,34130,2269,1415,3684,6080,2550,3530,14660,155,NA
01019,"Cherokee County, Alabama",25069,12261,12808,28422,18523,1530,832,240,101,24779,1481,1052,2533,3516,1606,1910,10079,169,NA
01021,"Chilton County, Alabama",45140,22048,23092,28497,30609,2504,1551,115,107,44781,2494,2652,5146,6422,3044,3378,18524,154,NA
01023,"Choctaw County, Alabama",12669,5980,6689,26343,9052,873,283,15,10,12543,634,400,1034,2388,1000,1388,4402,28,NA
01025,"Clarke County, Alabama",23058,11032,12026,29310,16015,1346,705,113,41,22750,1278,888,2166,5073,2346,2727,7694,107,NA
01027,"Clay County, Alabama",14209,6931,7278,27991,10053,926,279,78,0,13919,564,560,1124,2440,1144,1296,5176,137,NA
01029,"Cleburne County, Alabama",15144,7565,7579,28598,10630,1172,476,72,33,14989,672,840,1512,1931,848,1083,5593,13,NA
01031,"Coffee County, Alabama",53559,26626,26933,31227,36556,4786,2424,362,327,51466,3216,2374,5590,8592,3471,5121,22669,155,NA
01033,"Colbert County, Alabama",57270,27911,29359,30724,40835,4578,1821,559,410,56784,2228,2286,4514,8998,4159,4839,25195,79,NA
01035,"Conecuh County, Alabama",11576,5639,5937,24426,8382,642,316,40,118,11518,376,612,988,2122,924,1198,3664,34,NA
01037,"Coosa County, Alabama",10329,5306,5023,28998,8049,578,195,61,22,9919,329,283,612,1102,545,557,3851,57,NA
01039,"Covington County, Alabama",37542,18243,19299,28528,26447,2585,1280,313,135,37040,1936,1862,3798,6921,2981,3940,14928,173,NA
01041,"Crenshaw County, Alabama",13205,6451,6754,32396,9148,1092,405,61,15,12929,767,334,1101,1916,910,1006,5128,76,NA
01043,"Cullman County, Alabama",88284,43820,44464,29788,61520,7463,3105,491,197,87442,4954,4312,9266,11364,5161,6203,38671,39,NA
01045,"Dale County, Alabama",49455,24461,24994,28312,33687,4360,1654,279,162,46837,2562,2114,4676,8469,3896,4573,19769,114,NA
01047,"Dallas County, Alabama",38326,17895,20431,22798,25984,2633,1239,92,114,38031,1883,1742,3625,10230,4169,6061,14138,98,NA
01049,"DeKalb County, Alabama",71680,35847,35833,24915,48385,3996,2248,435,167,70836,5600,4726,10326,14251,6380,7871,30290,104,NA
01051,"Elmore County, Alabama",87694,42743,44951,34152,61046,9637,3846,670,596,82845,3331,3463,6794,7986,3272,4714,38872,245,0
01053,"Escambia County, Alabama",36755,18476,18279,21758,25461,2168,832,139,58,34273,2009,2217,4226,7449,3042,4407,12733,38,NA
01055,"Etowah County, Alabama",103348,50134,53214,28479,72715,7840,3418,1140,487,102350,6769,5196,11965,16146,6567,9579,43715,271,NA
01057,"Fayette County, Alabama",16297,7997,8300,27053,11428,943,284,210,49,16096,834,785,1619,3543,1543,2000,6236,17,NA
01059,"Franklin County, Alabama",32011,16071,15940,24874,21351,2204,777,137,48,31750,2337,1621,3958,5246,2200,3046,13403,54,NA
01061,"Geneva County, Alabama",26647,13037,13610,25644,18982,1842,743,21,35,26330,1793,1394,3187,5480,2695,2785,10627,44,NA
01063,"Greene County, Alabama",7706,3707,3999,20862,5449,579,242,75,15,7629,577,483,1060,2504,970,1534,2170,3,NA
01065,"Hale County, Alabama",14742,7020,7722,23690,9980,1079,411,19,125,14513,537,475,1012,3613,1661,1952,5358,29,NA
01067,"Henry County, Alabama",17282,8303,8979,30273,12561,1758,759,71,45,16997,770,864,1634,2608,812,1796,7154,74,NA
01069,"Houston County, Alabama",107040,51565,55475,32126,73993,10616,4321,1154,528,105970,6766,5677,12443,18878,7879,10999,45364,284,NA
01071,"Jackson County, Alabama",52618,25883,26735,27695,37823,3874,1843,228,178,52083,2861,2851,5712,9680,4279,5401,20023,226,NA
01073,"Jefferson County, Alabama",672265,319713,352552,38224,457310,96805,41229,16093,8545,665054,33107,26937,60044,103894,44297,59597,306222,2697,0
01075,"Lamar County, Alabama",13885,6930,6955,24794,9894,606,335,40,32,13727,660,415,1075,2107,981,1126,5222,49,NA
01077,"Lauderdale County, Alabama",94329,45493,48836,32678,64564,10372,4629,808,865,93301,4346,4535,8881,12188,4728,7460,42958,349,NA
01079,"Lawrence County, Alabama",33116,16299,16817,29486,23478,2364,1205,82,54,32852,1359,1632,2991,5182,2277,2905,13720,53,NA
01081,"Lee County, Alabama",175126,86692,88434,33083,107084,23707,13363,2439,3499,173839,7995,6874,14869,31003,14433,16570,80729,482,NA
01083,"Limestone County, Alabama",104199,52385,51814,37504,73067,13776,6347,793,661,101214,4850,3439,8289,11287,4582,6705,47315,413,NA
01085,"Lowndes County, Alabama",10153,4842,5311,23415,7035,739,316,53,40,9999,485,407,892,2552,977,1575,3642,24,NA
01087,"Macon County, Alabama",19198,8865,10333,22449,11880,1275,786,298,83,18946,1434,675,2109,4127,2005,2122,6787,129,NA
01089,"Madison County, Alabama",389781,191913,197868,44720,267305,71617,38510,4626,5763,384462,16712,13334,30046,40440,16721,23719,191093,1859,0
01091,"Marengo County, Alabama",19180,9100,10080,27210,12997,1654,1082,83,35,18950,1058,699,1757,4063,1690,2373,7399,96,NA
01093,"Marion County, Alabama",29203,14510,14693,25205,20785,1476,789,66,128,28627,1788,1367,3155,4707,2214,2493,11051,62,NA
01095,"Marshall County, Alabama",97923,48686,49237,29509,64995,9437,3371,669,446,96810,5804,4967,10771,15992,7008,8984,40866,155,NA
01097,"Mobile County, Alabama",413878,198642,215236,30482,279868,43806,17851,3791,2303,409201,25829,20239,46068,71353,29576,41777,173909,1375,NA
01099,"Monroe County, Alabama",19816,9758,10058,23090,13707,1072,647,91,42,19504,1062,1089,2151,4472,1926,2546,6220,15,NA
01101,"Montgomery County, Alabama",228132,107680,120452,32769,151442,29456,15534,3659,2353,222283,12403,11133,23536,42877,18057,24820,98021,652,NA
01103,"Morgan County, Alabama",123102,60953,62149,33223,84874,13494,4990,1074,682,121136,7696,5588,13284,16579,7051,9528,54268,460,NA
01105,"Perry County, Alabama",8479,3912,4567,16581,5314,537,192,20,60,8308,316,229,545,2478,867,1611,2156,20,NA
01107,"Pickens County, Alabama",18925,9149,9776,26912,13592,1229,543,179,21,17334,816,664,1480,3864,1677,2187,6691,0,NA
01109,"Pike County, Alabama",32997,15843,17154,26685,19205,3024,1692,278,328,32754,1416,1513,2929,7242,3739,3503,13338,201,NA
01111,"Randolph County, Alabama",22179,10787,11392,27558,15614,1892,859,105,80,21922,1096,756,1852,4277,2001,2276,8456,119,NA
01113,"Russell County, Alabama",58849,28125,30724,25855,39868,4088,1807,267,362,56945,3292,3391,6683,12816,5436,7380,23566,375,NA
01115,"St. Clair County, Alabama",91719,45680,46039,33571,64523,8608,3220,406,237,89637,3910,3458,7368,9786,4601,5185,41302,216,NA
01117,"Shelby County, Alabama",223916,109226,114690,45701,153645,45813,17640,3959,2656,221793,7521,6583,14104,15080,6661,8419,112772,566,NA
01119,"Sumter County, Alabama",12196,5586,6610,19720,7354,901,544,59,96,12050,636,531,1167,3285,1486,1799,4136,4,NA
01121,"Talladega County, Alabama",81105,39386,41719,29236,57406,5623,2966,474,468,77958,4238,3057,7295,14436,6030,8406,31194,477,NA
01123,"Tallapoosa County, Alabama",41251,20025,21226,29682,29557,3380,1466,334,185,40597,2210,1667,3877,6826,2824,4002,15388,77,NA
01125,"Tuscaloosa County, Alabama",231558,111807,119751,32141,141959,25838,11822,1978,4194,229518,8551,6793,15344,36412,16131,20281,107697,356,NA
01127,"Walker County, Alabama",64978,32122,32856,28204,45281,4268,1932,485,238,64152,4089,3704,7793,10437,4878,5559,25402,372,NA
01129,"Washington County, Alabama",15434,7664,7770,29210,10500,707,591,104,91,15291,594,819,1413,2415,1108,1307,5516,134,NA
01131,"Wilcox County, Alabama",10441,4892,5549,20442,7069,554,232,35,0,10241,522,444,966,2735,1142,1593,3174,64,NA
01133,"Winston County, Alabama",23655,11764,11891,26933,16998,1384,778,123,65,23299,1503,1125,2628,4217,1609,2608,9707,95,NA
04001,"Apache County, Arizona",66054,32843,33211,18930,42220,3475,1921,179,244,65317,8162,7267,15429,21058,10373,10685,18073,187,NA
04003,"Cochise County, Arizona",125504,64221,61283,31423,88211,14684,7074,1009,782,117864,4966,4079,9045,17553,7679,9874,46755,706,NA
04005,"Coconino County, Arizona",144705,71707,72998,32592,86631,20215,9779,1949,2357,144017,8551,7629,16180,22531,10742,11789,66342,589,NA
04007,"Gila County, Arizona",53419,26688,26731,29945,39673,4700,2047,250,178,52314,2691,2446,5137,9910,4439,5471,18434,113,NA
04009,"Graham County, Arizona",38453,20530,17923,24052,24362,2192,1046,86,75,35524,1745,1275,3020,6230,2633,3597,13864,125,NA
04011,"Greenlee County, Arizona",9483,5027,4456,29394,5854,774,141,61,0,9446,121,92,213,1208,536,672,4129,24,NA
04012,"La Paz County, Arizona",16681,8617,8064,30399,13188,1103,442,47,41,16548,1371,1148,2519,3435,1520,1915,5410,23,NA
04013,"Maricopa County, Arizona",4430871,2208150,2222721,41533,2987215,655112,282668,64811,42482,4391794,259437,222434,481871,503565,231096,272469,2146216,28790,27
04015,"Mohave County, Arizona",214229,108677,105552,32835,165754,14796,6310,1678,1095,210649,10691,8412,19103,33597,15914,17683,74493,1333,NA
04017,"Navajo County, Arizona",107110,54016,53094,22826,70604,7133,3781,813,481,104663,8002,7183,15185,26591,12967,13624,33309,485,NA
04019,"Pima County, Arizona",1042393,516095,526298,36494,705718,140892,74070,15813,16114,1019461,51003,41916,92919,151733,68616,83117,461211,4567,0
04021,"Pinal County, Arizona",433338,226232,207106,33158,302970,43734,16824,1962,2330,412632,21730,17861,39591,46424,21678,24746,167486,1429,0
04023,"Santa Cruz County, Arizona",47838,23193,24645,25619,30749,4308,2180,514,225,47630,3214,3461,6675,9622,4340,5282,18616,125,NA
04025,"Yavapai County, Arizona",237830,117352,120478,37666,184475,31291,15289,3450,2877,236398,14295,11531,25826,28765,14034,14731,92865,1248,0
04027,"Yuma County, Arizona",204374,105162,99212,27516,131335,14038,5745,1275,512,196063,14107,12313,26420,34654,15505,19149,77216,519,NA
05001,"Arkansas County, Arkansas",17024,8252,8772,28759,11889,1237,478,121,40,16787,543,512,1055,2816,1169,1647,7222,63,NA
05003,"Ashley County, Arkansas",19018,8986,10032,25568,13222,1090,338,32,71,18879,853,729,1582,4390,1731,2659,6525,145,NA
05005,"Baxter County, Arkansas",41801,20433,21368,30264,31982,4004,1275,308,221,41437,1675,1038,2713,5587,2387,3200,15129,192,NA
05007,"Benton County, Arkansas",286528,144085,142443,43359,188577,43246,18618,3563,1533,284862,14704,11944,26648,22289,10162,12127,141682,722,NA
05009,"Boone County, Arkansas",37662,18657,19005,28886,26260,2892,1102,238,135,37286,1337,1422,2759,4869,2129,2740,15850,92,NA
05011,"Bradley County, Arkansas",10461,5058,5403,23830,7105,620,175,59,37,10372,659,642,1301,1570,565,1005,3691,63,NA
05013,"Calhoun County, Arkansas",4773,2420,2353,24047,3462,266,105,58,5,4722,212,172,384,574,296,278,1643,16,NA
05015,"Carroll County, Arkansas",28362,14305,14057,29123,20180,2932,1021,269,105,28080,2033,1455,3488,4329,2009,2320,11683,345,NA
05017,"Chicot County, Arkansas",10234,5150,5084,24156,7065,889,290,39,27,9542,628,311,939,2618,1144,1474,3224,42,NA
05019,"Clark County, Arkansas",21469,10113,11356,24532,12424,2161,742,71,312,21219,866,1117,1983,3812,1616,2196,9777,105,NA
05021,"Clay County, Arkansas",14537,6958,7579,26554,10342,898,642,33,18,14446,726,426,1152,2789,1120,1669,6194,87,NA
05023,"Cleburne County, Arkansas",24948,12469,12479,31041,18612,2123,803,161,112,24624,1072,694,1766,3469,1732,1737,9354,65,NA
05025,"Cleveland County, Arkansas",7548,3494,4054,26479,5413,546,251,30,32,7474,134,131,265,1013,380,633,2886,47,NA
05027,"Columbia County, Arkansas",22707,10991,11716,27243,14189,1884,684,50,76,22335,900,745,1645,4675,1824,2851,9137,62,NA
05029,"Conway County, Arkansas",20782,10354,10428,28694,14483,2044,541,67,121,20688,935,566,1501,4313,2168,2145,8867,96,NA
05031,"Craighead County, Arkansas",111038,54232,56806,31298,71091,12275,5369,1606,802,109959,5813,3620,9433,20511,8306,12205,50201,181,NA
05033,"Crawford County, Arkansas",60593,29905,30688,28920,41093,5977,1643,470,259,59825,2658,2668,5326,10620,4686,5934,24303,152,NA
05035,"Crittenden County, Arkansas",47945,22739,25206,27834,30572,3808,1312,120,149,47446,2223,1845,4068,9305,3895,5410,19881,51,NA
05037,"Cross County, Arkansas",16827,8161,8666,27776,11566,1235,492,63,68,16621,716,516,1232,3357,1339,2018,6934,54,NA
05039,"Dallas County, Arkansas",6472,3185,3287,26378,4671,408,176,17,8,6057,152,175,327,723,286,437,2617,16,NA
05041,"Desha County, Arkansas",11285,5452,5833,21588,7691,636,294,4,71,11228,451,549,1000,3044,1372,1672,4027,41,NA
05043,"Drew County, Arkansas",17309,8401,8908,27349,10906,1856,628,80,165,16981,455,349,804,3513,1477,2036,6993,33,NA
05045,"Faulkner County, Arkansas",124611,60844,63767,31301,77167,15574,7193,1376,920,122826,5710,3860,9570,18478,7730,10748,58110,346,NA
05047,"Franklin County, Arkansas",17160,8427,8733,25517,12025,1051,299,78,51,16920,618,514,1132,3412,1706,1706,6644,71,NA
05049,"Fulton County, Arkansas",12183,6091,6092,22895,8708,830,387,32,4,12001,745,526,1271,1841,699,1142,4212,31,NA
05051,"Garland County, Arkansas",100021,48360,51661,31854,72911,11550,5152,929,776,98915,4594,4474,9068,16604,6867,9737,41090,605,NA
05053,"Grant County, Arkansas",18022,9080,8942,35170,12609,1730,493,145,0,17821,571,509,1080,2413,1271,1142,7695,23,NA
05055,"Greene County, Arkansas",45954,22749,23205,26941,30946,3283,1551,190,101,45434,2611,1535,4146,7892,3707,4185,19536,158,NA
05057,"Hempstead County, Arkansas",20037,9734,10303,25577,13301,1279,631,161,29,19786,961,1273,2234,4536,1688,2848,7626,4,NA
05059,"Hot Spring County, Arkansas",33129,17621,15508,25486,24022,2420,1063,126,115,30815,1201,1172,2373,6093,2857,3236,12758,160,NA
05061,"Howard County, Arkansas",12779,6099,6680,25458,8505,844,382,28,20,12601,831,736,1567,2301,820,1481,5285,1,NA
05063,"Independence County, Arkansas",37910,18947,18963,27867,25382,2948,1026,181,187,37373,2159,1610,3769,7124,3589,3535,15894,168,NA
05065,"Izard County, Arkansas",13748,7294,6454,25331,10452,1391,455,82,51,12681,632,234,866,2503,1207,1296,4112,144,NA
05067,"Jackson County, Arkansas",16784,8419,8365,23048,11927,927,363,75,49,14515,722,492,1214,2957,1244,1713,5825,40,NA
05069,"Jefferson County, Arkansas",66934,33541,33393,24571,45704,6384,2120,376,330,62146,2185,1656,3841,11818,5170,6648,24926,185,NA
05071,"Johnson County, Arkansas",25925,12974,12951,22457,17235,1771,572,126,123,25720,1069,1049,2118,5327,2264,3063,9860,41,NA
05073,"Lafayette County, Arkansas",6277,3218,3059,23699,4514,324,134,21,0,6170,326,246,572,1328,662,666,2313,44,NA
05075,"Lawrence County, Arkansas",16258,8130,8128,25301,10950,957,389,19,53,15992,870,543,1413,2791,1120,1671,6312,52,NA
05077,"Lee County, Arkansas",8666,4882,3784,20338,6193,394,68,5,10,7170,358,187,545,1964,776,1188,2514,24,NA
05079,"Lincoln County, Arkansas",13016,8335,4681,18191,10007,547,250,8,9,8389,281,409,690,1481,474,1007,3550,17,NA
05081,"Little River County, Arkansas",12024,5849,6175,28764,8415,974,296,57,13,11866,319,258,577,1394,483,911,5008,42,NA
05083,"Logan County, Arkansas",21247,10501,10746,28495,15192,1379,582,178,40,21010,731,671,1402,3036,1303,1733,9042,124,NA
05085,"Lonoke County, Arkansas",74292,36875,37417,32720,49756,6608,2839,307,162,72401,2932,2511,5443,8680,3937,4743,34314,296,NA
05087,"Madison County, Arkansas",16737,8474,8263,27709,11654,973,356,79,27,16664,1036,703,1739,2731,1360,1371,6891,16,0
05089,"Marion County, Arkansas",16905,8389,8516,25315,12875,1161,692,48,60,16752,689,533,1222,2970,1222,1748,5824,57,NA
05091,"Miller County, Arkansas",42682,21257,21425,26572,28953,2614,1591,161,151,41475,2505,1724,4229,8496,3902,4594,15949,203,NA
05093,"Mississippi County, Arkansas",40361,19837,20524,27863,26228,2413,1191,198,80,39561,1914,1375,3289,8599,3514,5085,16253,132,NA
05095,"Monroe County, Arkansas",6787,3278,3509,24117,4771,468,146,60,3,6695,386,197,583,1592,650,942,2286,1,NA
05097,"Montgomery County, Arkansas",8555,4380,4175,26815,6467,760,239,49,12,8427,539,448,987,1527,881,646,3222,38,NA
05099,"Nevada County, Arkansas",8292,4058,4234,22041,5657,476,132,0,11,8126,257,141,398,2248,1001,1247,3117,11,NA
05101,"Newton County, Arkansas",7243,3724,3519,26544,5236,494,264,11,5,7157,259,178,437,814,376,438,2785,13,NA
05103,"Ouachita County, Arkansas",22606,11039,11567,25289,15755,1573,595,100,88,22251,910,539,1449,4230,1946,2284,8345,118,NA
05105,"Perry County, Arkansas",10055,5182,4873,26967,7152,782,281,22,2,9951,286,243,529,1526,683,843,3749,24,NA
05107,"Phillips County, Arkansas",16373,7600,8773,22644,10670,1021,487,35,83,16198,737,492,1229,4946,2311,2635,5529,20,NA
05109,"Pike County, Arkansas",10205,5013,5192,28392,7133,866,410,24,20,10052,522,508,1030,1745,795,950,4210,25,NA
05111,"Poinsett County, Arkansas",22997,11246,11751,24807,15626,1297,426,58,23,22675,1192,923,2115,4716,1987,2729,9114,62,NA
05113,"Polk County, Arkansas",19384,9508,9876,30395,13516,1513,530,120,36,19234,1147,683,1830,3393,1499,1894,7479,68,NA
05115,"Pope County, Arkansas",63475,31401,32074,28018,41041,6437,2533,372,459,62863,3110,2254,5364,10728,4283,6445,26768,362,NA
05117,"Prairie County, Arkansas",8217,4128,4089,29018,5994,596,305,34,23,8053,394,186,580,797,386,411,3540,27,NA
05119,"Pulaski County, Arkansas",398322,190970,207352,39146,270873,59004,27515,8721,5095,391529,19809,14653,34462,64768,28305,36463,186769,2255,0
05121,"Randolph County, Arkansas",18619,9393,9226,25528,12793,1248,502,89,150,18345,779,593,1372,3519,1799,1720,6962,2,NA
05123,"St. Francis County, Arkansas",23138,12793,10345,20991,16284,1213,787,110,51,20218,1232,518,1750,5659,2481,3178,7810,92,NA
05125,"Saline County, Arkansas",123988,60702,63286,36151,86181,16876,5736,1238,675,122689,4167,2943,7110,11688,5224,6464,58391,381,NA
05127,"Scott County, Arkansas",9871,5205,4666,23086,6909,638,155,22,17,9792,507,518,1025,1677,775,902,4047,116,NA
05129,"Searcy County, Arkansas",7880,3944,3936,22384,5734,637,158,42,20,7778,290,155,445,2054,862,1192,2844,21,NA
05131,"Sebastian County, Arkansas",128184,63156,65028,32577,85873,12935,5012,1261,1334,126675,7994,6141,14135,20818,9397,11421,56890,759,NA
05133,"Sevier County, Arkansas",15913,7977,7936,26369,9814,764,345,29,7,15805,1694,1218,2912,3144,1379,1765,6683,62,NA
05135,"Sharp County, Arkansas",17422,8559,8863,25283,12611,946,321,107,78,17213,688,302,990,2725,1182,1543,6216,41,NA
05137,"Stone County, Arkansas",12393,6105,6288,21640,9080,847,367,7,90,12287,466,594,1060,2603,1154,1449,3856,30,NA
05139,"Union County, Arkansas",38815,18966,19849,29252,26493,3250,1274,293,77,38394,1613,760,2373,7135,3021,4114,15967,53,NA
05141,"Van Buren County, Arkansas",15900,7814,8086,26183,11769,1229,546,116,81,15733,920,552,1472,2971,1365,1606,5364,231,NA
05143,"Washington County, Arkansas",247331,124636,122695,34531,151212,30466,14964,3650,3035,245376,16614,13255,29869,36258,17078,19180,119440,532,7
05145,"White County, Arkansas",77118,37704,39414,27364,50533,6067,2953,648,683,76690,4155,3214,7369,11867,4793,7074,31811,263,NA
05147,"Woodruff County, Arkansas",6259,3105,3154,29216,4387,375,298,48,3,6135,233,188,421,1146,469,677,2625,33,NA
05149,"Yell County, Arkansas",20342,10309,10033,26044,13857,1306,419,111,77,20057,988,666,1654,2480,1147,1333,8902,149,NA
06001,"Alameda County, California",1663823,826561,837262,60193,1193888,343246,188430,37072,39387,1654106,37879,28606,66485,149843,67697,82146,827327,8906,0
06003,"Alpine County, California",1515,882,633,55425,1068,248,86,47,42,1515,57,40,97,208,157,51,638,0,NA
06005,"Amador County, California",40577,22007,18570,40379,31901,4598,1287,534,141,37591,1256,561,1817,2945,1361,1584,15508,81,NA
06007,"Butte County, California",213605,106376,107229,36374,138986,28092,9286,3363,2113,211587,8013,5953,13966,38015,17650,20365,91975,728,0
06009,"Calaveras County, California",45674,22749,22925,37935,35412,5150,1723,410,294,45341,1387,1263,2650,5915,2976,2939,17014,145,NA
06011,"Colusa County, California",21811,11112,10699,31915,14021,1530,359,82,32,21654,1037,943,1980,2364,1033,1331,9477,71,NA
06013,"Contra Costa County, California",1162648,573074,589574,59083,808485,219701,95646,26142,18266,1157711,30685,23154,53839,95255,43444,51811,556391,6356,0
06015,"Del Norte County, California",27462,14809,12653,28396,19672,2193,841,290,161,25220,808,729,1537,3585,1585,2000,9607,71,NA
06017,"El Dorado County, California",191713,96045,95668,55455,140802,35536,11964,3985,1953,190659,4398,3578,7976,16364,7110,9254,86127,617,NA
06019,"Fresno County, California",1008280,506526,501754,30130,624392,96794,32332,11596,5285,997018,43729,28144,71873,193675,90071,103604,411511,4944,0
06021,"Glenn County, California",28657,14763,13894,28106,18475,2120,432,113,82,28434,1788,1316,3104,4335,1768,2567,12118,328,NA
06023,"Humboldt County, California",136132,67729,68403,33988,93612,19011,6619,2135,1333,135228,5061,3244,8305,26394,12411,13983,58327,574,NA
06025,"Imperial County, California",179578,92430,87148,21216,110201,13008,3370,843,319,171685,6394,5337,11731,36092,15914,20178,59335,841,NA
06027,"Inyo County, California",18829,9617,9212,36673,13867,2406,1236,98,275,18454,760,478,1238,2199,1196,1003,8094,119,NA
06029,"Kern County, California",906883,464093,442790,27976,553334,66940,25009,6336,3086,882898,40189,28380,68569,170013,76694,93319,351806,3106,0
06031,"Kings County, California",152515,84277,68238,26193,95084,9541,2996,795,669,136167,5360,4757,10117,22634,10783,11851,56893,452,NA
06033,"Lake County, California",68024,34144,33880,34020,48945,5943,2012,646,313,67361,2968,1391,4359,11065,5082,5983,24313,183,NA
06035,"Lassen County, California",31873,20127,11746,23646,23744,2138,427,213,94,24109,980,798,1778,3645,1983,1662,8909,4,NA
06037,"Los Angeles County, California",9936690,4937101,4999589,41847,6909650,1542422,568367,177960,100810,9866623,510473,378262,888735,1343978,608851,735127,4737721,63140,76
06039,"Madera County, California",157243,77200,80043,28158,99045,11497,3900,1034,556,150569,6558,4901,11459,30154,14046,16108,57706,2538,NA
06041,"Marin County, California",260485,127983,132502,87300,191565,65256,31365,13822,6657,257074,5821,3664,9485,17809,8317,9492,126445,1120,0
06043,"Mariposa County, California",17130,8635,8495,36106,13371,2607,951,145,165,16990,725,503,1228,2712,1482,1230,7072,46,NA
06045,"Mendocino County, California",91145,45110,46035,34977,65163,9382,4315,1411,523,90359,4963,3354,8317,14483,6953,7530,36841,220,0
06047,"Merced County, California",282290,143519,138771,26869,168503,17165,5319,1285,908,279730,15374,9832,25206,51272,22446,28826,106381,4417,0
06049,"Modoc County, California",8651,4205,4446,28860,6511,1062,390,61,38,8479,438,299,737,1430,627,803,3184,30,NA
06051,"Mono County, California",13219,7279,5940,43315,9628,1897,541,440,175,13020,1251,665,1916,1478,1028,450,7400,53,NA
06053,"Monterey County, California",437609,223186,214423,37741,279734,45473,20444,5737,4059,422849,23224,18798,42022,51913,23729,28184,189526,13250,NA
06055,"Napa County, California",137384,68760,68624,54306,98232,24039,8534,3133,1464,135870,4364,3900,8264,10620,5022,5598,66906,571,NA
06057,"Nevada County, California",102322,50630,51692,46706,79007,19803,7518,2131,1210,101303,3343,2370,5713,10505,4895,5610,44318,396,NA
06059,"Orange County, California",3175227,1578013,1597214,50683,2197677,591937,238150,69299,40432,3159196,120652,97286,217938,303810,136472,167338,1563277,16468,18
06061,"Placer County, California",406608,200326,206282,54004,286915,79373,29273,9413,3711,403676,7031,6478,13509,27446,12422,15024,187335,1477,NA
06063,"Plumas County, California",19650,10167,9483,41701,15236,2227,746,137,117,19485,521,444,965,2101,944,1157,7380,26,NA
06065,"Riverside County, California",2429487,1220393,1209094,35356,1594000,244893,100450,22490,15613,2407200,106683,87191,193874,272432,123198,149234,1048421,10280,0
06067,"Sacramento County, California",1579211,779030,800181,39763,1077155,227553,82498,28304,13049,1565603,46809,34124,80933,204388,94103,110285,727094,8413,0
06069,"San Benito County, California",64753,32844,31909,40799,42300,6667,1989,458,191,64598,1993,2031,4024,4832,2072,2760,30710,262,0
06071,"San Bernardino County, California",2180563,1094825,1085738,31348,1388742,201183,81561,16850,11786,2140477,102798,81157,183955,294246,132723,161523,946303,9401,5
06073,"San Diego County, California",3289701,1667851,1621850,46957,2257620,564011,242010,65544,55116,3180185,129599,101468,231067,338752,152530,186222,1622954,17124,8
06075,"San Francisco County, California",851036,438093,412943,86186,680343,238669,111452,34832,21821,846845,18934,11472,30406,87849,43146,44703,487526,9139,11
06077,"San Joaquin County, California",779445,391204,388241,33870,495879,68376,22666,6319,3337,769518,29272,20466,49738,98352,44531,53821,325292,2307,0
06079,"San Luis Obispo County, California",281712,142477,139235,47390,189527,45318,17559,5987,3103,276398,8901,7378,16279,33728,16338,17390,129192,916,0
06081,"San Mateo County, California",754250,376542,377708,77741,547817,161021,81293,22518,24847,750550,16546,11707,28253,48137,21092,27045,393729,5462,8
06083,"Santa Barbara County, California",445213,223753,221460,44635,277891,59212,25044,7608,7279,437957,23711,18406,42117,57513,25619,31894,204766,1480,0
06085,"Santa Clara County, California",1916831,978952,937879,73017,1341405,377331,262781,39373,62687,1906731,43069,32786,75855,129834,59390,70444,975427,9404,0
06087,"Santa Cruz County, California",268571,134256,134315,52887,180171,44286,21144,5788,5319,267448,8059,6437,14496,29302,13950,15352,129470,2402,0
06089,"Shasta County, California",181852,89879,91973,36458,128883,19783,6335,2367,842,180267,6408,5503,11911,23753,9952,13801,74304,379,NA
06091,"Sierra County, California",2916,1411,1505,37692,2249,265,147,118,7,2854,142,168,310,359,162,197,1216,6,NA
06093,"Siskiyou County, California",44049,22035,22014,33650,32134,4772,1505,530,262,43879,1893,1217,3110,7289,3500,3789,15974,98,NA
06095,"Solano County, California",450995,225302,225693,42886,312706,60316,19531,5380,2955,439325,12351,9032,21383,39705,18216,21489,209755,1883,NA
06097,"Sonoma County, California",488436,240478,247958,52523,354851,82815,33801,12180,5503,484661,15088,12081,27169,42925,19300,23625,242102,2454,0
06099,"Stanislaus County, California",552063,275687,276376,32044,350685,44136,13144,4413,2194,549226,19813,13595,33408,75125,34972,40153,229451,1838,5
06101,"Sutter County, California",99101,49828,49273,34039,64986,9068,2964,840,530,97664,3210,2817,6027,13065,5637,7428,41767,354,NA
06103,"Tehama County, California",65484,32562,32922,33800,44986,5951,1664,473,86,65037,2558,1742,4300,10483,5106,5377,24769,191,0
06105,"Trinity County, California",15889,8243,7646,32856,12553,1463,596,134,215,15737,1203,871,2074,3457,1379,2078,5176,75,NA
06107,"Tulare County, California",473446,238140,235306,26282,280911,28337,11441,3041,1051,469112,22398,14846,37244,86391,40007,46384,184620,1249,NA
06109,"Tuolumne County, California",54993,28367,26626,40095,42078,6941,2422,626,294,52419,1906,1240,3146,5887,2671,3216,19951,110,NA
06111,"Ventura County, California",842009,419805,422204,45846,575974,125787,51062,13864,9224,834383,38428,30146,68574,74315,34122,40193,402639,2283,0
06113,"Yolo County, California",217141,105912,111229,41703,129126,28888,14307,6056,6623,215593,5585,4451,10036,36521,16268,20253,100577,1117,0
06115,"Yuba County, California",81705,41643,40062,30036,51600,5915,2241,480,321,78912,3148,2315,5463,12375,5904,6471,33422,209,NA
08001,"Adams County, Colorado",520149,264853,255296,37550,338792,62602,23725,2665,3001,516857,31278,24446,55724,49625,22826,26799,271582,2342,0
08003,"Alamosa County, Colorado",16460,8160,8300,28945,9807,1551,830,193,193,16121,811,551,1362,2418,1105,1313,7632,29,NA
08005,"Arapahoe County, Colorado",654453,327156,327297,49530,450081,125322,56515,12254,8093,648160,30811,25637,56448,51766,24153,27613,349283,3262,0
08007,"Archuleta County, Colorado",13509,6827,6682,39155,10417,2539,1211,215,143,13392,858,619,1477,1092,581,511,5858,10,NA
08009,"Baca County, Colorado",3496,1731,1765,28115,2504,444,127,27,12,3404,134,92,226,781,323,458,1468,20,NA
08011,"Bent County, Colorado",5561,3453,2108,19041,4265,410,216,33,2,4234,199,99,298,1146,595,551,1674,27,NA
08013,"Boulder County, Colorado",328658,166315,162343,57339,217821,75431,42263,8318,11717,326426,8639,5781,14420,35674,18188,17486,175188,1281,0
08014,"Broomfield County, Colorado",73946,37204,36742,60862,52126,18430,8967,1370,1665,73517,2107,1683,3790,3679,1681,1998,41490,441,NA
08015,"Chaffee County, Colorado",19564,10215,9349,38167,15510,3738,1971,507,209,18174,832,655,1487,2137,997,1140,8649,127,NA
08017,"Cheyenne County, Colorado",1726,859,867,38791,1225,196,73,10,8,1683,66,56,122,183,107,76,878,0,NA
08019,"Clear Creek County, Colorado",9403,4773,4630,59550,7643,2202,1521,334,149,9312,566,295,861,617,246,371,5360,10,NA
08021,"Conejos County, Colorado",7553,3827,3726,25240,4978,818,350,42,17,7509,568,516,1084,1177,599,578,2946,20,NA
08023,"Costilla County, Colorado",3534,1775,1759,24318,2617,441,158,20,0,3515,185,96,281,792,432,360,1129,6,NA
08025,"Crowley County, Colorado",5782,3922,1860,20909,4191,387,141,5,1,4449,257,35,292,1076,790,286,1567,0,NA
08027,"Custer County, Colorado",4885,2371,2514,37232,3787,853,369,66,93,4876,247,283,530,376,215,161,2029,0,NA
08029,"Delta County, Colorado",31173,15642,15531,33055,22899,3710,1534,271,95,30172,1734,1591,3325,4525,1972,2553,11981,74,NA
08031,"Denver County, Colorado",710800,359302,351498,56381,519431,172213,74659,23682,11230,703988,37016,27054,64070,81703,37653,44050,409324,3731,7
08033,"Dolores County, Colorado",2329,1297,1032,38098,1907,300,141,61,0,2329,119,74,193,389,214,175,1043,0,NA
08035,"Douglas County, Colorado",360206,181600,178606,63186,243113,94158,40565,6891,4265,358371,7128,5905,13033,10799,4418,6381,195197,1110,0
08037,"Eagle County, Colorado",55650,29968,25682,55007,40007,14027,5093,1211,395,55500,3538,2253,5791,4457,1871,2586,31408,298,NA
08039,"Elbert County, Colorado",26457,13448,13009,55535,19030,4850,1538,215,175,26378,630,700,1330,1124,506,618,13823,83,NA
08041,"El Paso County, Colorado",730323,372145,358178,41444,478864,117443,58200,8901,7867,693511,28971,23248,52219,65325,29856,35469,368980,2809,NA
08043,"Fremont County, Colorado",49107,28582,20525,28224,38046,5340,1879,322,153,40621,1665,1121,2786,6081,2778,3303,16657,104,NA
08045,"Garfield County, Colorado",61683,31693,29990,39024,41298,8965,3296,1265,389,61074,6115,4555,10670,4917,2324,2593,33232,210,NA
08047,"Gilpin County, Colorado",5856,3103,2753,57593,4658,973,599,227,245,5807,223,283,506,538,182,356,3557,8,NA
08049,"Grand County, Colorado",15724,8211,7513,43553,12048,2648,1459,447,3,15679,911,1010,1921,1345,546,799,8728,53,NA
08051,"Gunnison County, Colorado",17018,9190,7828,44167,11260,4652,1411,353,266,16942,809,406,1215,1746,814,932,9984,25,0
08053,"Hinsdale County, Colorado",911,425,486,46944,787,197,101,53,0,911,41,74,115,67,27,40,408,0,NA
08055,"Huerfano County, Colorado",6896,3607,3289,29508,5162,847,347,123,29,6749,193,217,410,1390,586,804,2498,0,NA
08057,"Jackson County, Colorado",1440,748,692,29657,1076,174,103,19,0,1434,92,51,143,299,153,146,660,3,NA
08059,"Jefferson County, Colorado",580519,292303,288216,54571,424697,132350,56924,10136,9241,574705,16883,13089,29972,38194,17687,20507,317312,2473,0
08061,"Kiowa County, Colorado",1347,632,715,27957,930,117,45,2,3,1317,55,55,110,210,77,133,624,12,NA
08063,"Kit Carson County, Colorado",7039,3499,3540,36039,4798,578,200,78,10,6955,448,395,843,652,313,339,3444,33,NA
08065,"Lake County, Colorado",7403,3920,3483,44794,5276,1245,615,159,51,7345,796,405,1201,527,175,352,4390,86,NA
08067,"La Plata County, Colorado",55983,28379,27604,44614,40389,12325,4837,1066,740,55580,3174,2109,5283,6185,2861,3324,28762,246,NA
08069,"Larimer County, Colorado",359363,180193,179170,46676,239134,73222,34627,6414,7425,356521,11453,9602,21055,40057,18430,21627,189742,1387,NA
08071,"Las Animas County, Colorado",14422,7537,6885,29432,10599,1069,389,115,181,14004,752,500,1252,2627,1299,1328,5703,113,NA
08073,"Lincoln County, Colorado",5583,3377,2206,27610,4203,766,128,33,29,4228,212,131,343,485,214,271,2169,16,NA
08075,"Logan County, Colorado",21302,11594,9708,29440,15042,1791,1026,87,62,20344,966,504,1470,2332,1324,1008,10183,11,NA
08077,"Mesa County, Colorado",156131,77615,78516,36303,109465,22061,7328,1862,1624,154883,8900,6504,15404,17446,7668,9778,72651,1351,NA
08079,"Mineral County, Colorado",794,395,399,37647,685,278,73,29,15,791,70,45,115,89,23,66,413,2,NA
08081,"Moffat County, Colorado",13232,6702,6530,33019,9006,1333,327,72,118,13074,823,493,1316,1947,842,1105,6062,0,NA
08083,"Montezuma County, Colorado",26070,13026,13044,31044,18740,3328,1685,258,363,25867,1539,1356,2895,3231,1649,1582,10741,87,NA
08085,"Montrose County, Colorado",42823,21392,21431,35755,31003,5769,1929,463,432,42404,3127,2499,5626,4904,2140,2764,18297,236,NA
08087,"Morgan County, Colorado",29045,15015,14030,30422,18881,2194,918,140,96,28624,2092,1220,3312,3662,1576,2086,13360,71,NA
08089,"Otero County, Colorado",18580,9409,9171,25789,12641,1399,685,138,94,18396,824,640,1464,4350,2190,2160,7033,167,NA
08091,"Ouray County, Colorado",4936,2558,2378,47768,4175,1275,534,187,73,4936,396,326,722,239,69,170,2167,3,NA
08093,"Park County, Colorado",17597,9422,8175,48221,14180,3305,1230,187,310,17501,977,568,1545,1185,705,480,8580,29,NA
08095,"Phillips County, Colorado",4493,2203,2290,37996,2966,572,100,105,2,4410,242,113,355,612,233,379,2055,0,NA
08097,"Pitkin County, Colorado",17325,9070,8255,87561,13499,5045,2218,910,346,17284,369,383,752,1150,547,603,10314,210,0
08099,"Prowers County, Colorado",11968,6079,5889,29026,7543,777,401,156,42,11833,787,459,1246,2037,1005,1032,5353,83,NA
08101,"Pueblo County, Colorado",168135,83410,84725,31513,115954,18044,7741,1311,812,164494,5866,4525,10391,27274,12735,14539,69850,321,NA
08103,"Rio Blanco County, Colorado",6511,3450,3061,30140,4343,711,276,26,21,6376,360,235,595,799,426,373,2852,4,NA
08105,"Rio Grande County, Colorado",11442,5913,5529,34328,8092,1693,700,109,29,11265,917,682,1599,1151,512,639,4989,36,NA
08107,"Routt County, Colorado",24944,13144,11800,58304,18742,5931,2353,907,188,24778,1195,919,2114,1965,892,1073,13686,49,0
08109,"Saguache County, Colorado",6454,3274,3180,34311,4901,627,453,34,81,6412,402,311,713,1123,511,612,2660,0,NA
08111,"San Juan County, Colorado",690,371,319,42678,552,134,92,4,0,690,78,36,114,132,68,64,372,0,NA
08113,"San Miguel County, Colorado",8082,4417,3665,55184,6282,2874,727,262,42,8066,413,421,834,682,334,348,4897,160,NA
08115,"Sedgwick County, Colorado",2391,1208,1183,32776,1718,309,123,7,16,2359,104,79,183,379,145,234,1062,3,NA
08117,"Summit County, Colorado",30955,17012,13943,54935,24050,7876,3115,1151,426,30905,2005,1405,3410,2275,1123,1152,18644,39,NA
08119,"Teller County, Colorado",24758,12427,12331,41836,19324,4448,2252,316,320,24637,757,973,1730,1727,704,1023,11249,120,NA
08121,"Washington County, Colorado",4817,2547,2270,33374,3370,561,210,23,31,4604,105,106,211,446,198,248,2247,3,NA
08123,"Weld County, Colorado",331466,168644,162822,39480,215564,42730,17650,3132,2572,329254,15592,12340,27932,31432,13850,17582,166155,1176,NA
08125,"Yuma County, Colorado",9938,5049,4889,32575,6666,1020,520,65,24,9782,742,762,1504,1355,708,647,4617,20,NA
09110,"Capitol Planning Region, Connecticut",977165,477460,499705,47802,675246,154850,90201,20616,11882,963750,21800,16872,38672,101370,45497,55873,485812,3392,NA
09120,"Greater Bridgeport Planning Region, Connecticut",326381,159824,166557,48201,221540,52095,30144,7205,2991,323892,13564,11173,24737,42156,18019,24137,156551,1741,NA
09130,"Lower Connecticut River Valley Planning Region, Connecticut",175244,86193,89051,54712,128960,32151,19862,3649,2714,173196,3111,2425,5536,10964,4922,6042,93089,839,NA
09140,"Naugatuck Valley Planning Region, Connecticut",451887,220494,231393,44275,320582,60414,35458,6825,3960,446694,11542,9145,20687,45555,19736,25819,223763,2248,NA
09150,"Northeastern Connecticut Planning Region, Connecticut",95687,47915,47772,40723,68920,9844,6075,597,736,94597,2298,1778,4076,8356,3671,4685,46788,358,NA
09160,"Northwest Hills Planning Region, Connecticut",112696,55997,56699,52279,82679,18125,10119,2215,902,111682,2621,1960,4581,10462,4699,5763,56900,615,NA
09170,"South Central Connecticut Planning Region, Connecticut",571298,276095,295203,46781,395812,81523,51835,15165,11377,566416,16586,12068,28654,64563,28729,35834,282725,2488,NA
09180,"Southeastern Connecticut Planning Region, Connecticut",280293,140310,139983,43292,197755,38034,22122,3865,2845,270461,7569,4293,11862,26614,12156,14458,137271,1288,NA
09190,"Western Connecticut Planning Region, Connecticut",620666,304908,315758,76090,429296,126881,75387,21548,9014,616328,26558,18749,45307,45652,19596,26056,315294,3044,NA
10001,"Kent County, Delaware",182400,88272,94128,33191,122811,19471,10186,1331,1289,178816,7027,5343,12370,21850,9344,12506,82419,621,NA
10003,"New Castle County, Delaware",570567,277558,293009,44725,395423,86580,46502,8210,10053,562979,16350,13611,29961,58355,25494,32861,284140,2770,5
10005,"Sussex County, Delaware",240668,117079,123589,42958,182130,33162,18345,3639,2589,238058,9763,6641,16404,27585,12094,15491,102322,943,NA
11001,"District of Columbia, District of Columbia",670587,320797,349790,71297,484596,124860,109410,48095,21167,661596,13456,9136,22592,98039,42700,55339,366965,5943,6
12001,"Alachua County, Florida",279729,135121,144608,35684,169342,40168,22264,7644,8980,277077,12175,9767,21942,53070,24807,28263,130463,1420,0
12003,"Baker County, Florida",27969,14996,12973,28612,18827,1603,749,197,111,24868,1421,1384,2805,3398,1459,1939,11312,198,NA
12005,"Bay County, Florida",181055,90237,90818,36868,129413,22211,9060,1977,1218,176174,13528,10651,24179,21755,9475,12280,85923,620,0
12007,"Bradford County, Florida",27816,15418,12398,25276,20149,1602,657,225,169,24046,1167,1448,2615,4352,1998,2354,10616,167,NA
12009,"Brevard County, Florida",610723,300904,309819,40111,455626,91368,45017,7401,6087,604136,33084,27564,60648,60927,27493,33434,269483,2438,0
12011,"Broward County, Florida",1940907,952900,988007,39753,1382985,299209,126236,40720,17078,1927396,143352,124664,268016,238880,107179,131701,965176,15739,56
12013,"Calhoun County, Florida",13753,7715,6038,21324,10046,769,269,62,12,11965,1371,977,2348,2374,1078,1296,4482,36,NA
12015,"Charlotte County, Florida",189900,93505,96395,38466,157728,24826,10730,2700,1384,186232,10691,8391,19082,19490,9300,10190,66322,1013,0
12017,"Citrus County, Florida",155173,76008,79165,33514,123782,15052,6543,1834,938,152802,8964,7505,16469,22833,11028,11805,48459,740,NA
12019,"Clay County, Florida",219650,108845,110805,37334,151800,28107,10217,2410,1136,215982,10546,8337,18883,20352,9245,11107,103613,1245,NA
12021,"Collier County, Florida",380221,188078,192143,56666,291752,66537,31325,10073,5075,378258,25520,18973,44493,39131,18523,20608,158573,2126,7
12023,"Columbia County, Florida",69832,35762,34070,28317,48482,5293,1799,342,343,65321,4471,4123,8594,10196,5056,5140,26940,511,NA
12027,"DeSoto County, Florida",34258,19234,15024,21726,25022,1960,687,141,112,32651,4419,1969,6388,8601,4535,4066,12092,121,NA
12029,"Dixie County, Florida",16737,9323,7414,20508,12519,661,209,111,18,15205,1294,1140,2434,2445,1221,1224,5345,57,NA
12031,"Duval County, Florida",995708,484498,511210,37376,683191,146544,53477,12933,7319,971845,62260,51645,113905,139341,60531,78810,489335,7728,6
12033,"Escambia County, Florida",321296,159191,162105,33656,218227,38493,16218,3495,3051,304910,19761,15728,35489,44874,19890,24984,146059,1631,0
12035,"Flagler County, Florida",117515,56801,60714,40463,90826,16803,6603,1564,798,116843,6628,6581,13209,11382,5359,6023,47069,460,NA
12037,"Franklin County, Florida",12276,6827,5449,31433,9704,1120,662,141,110,10752,1058,844,1902,2325,1088,1237,4116,112,NA
12039,"Gadsden County, Florida",43746,20875,22871,23898,30567,3856,1735,165,256,41170,3313,2515,5828,10460,4835,5625,16195,51,NA
12041,"Gilchrist County, Florida",18070,9320,8750,31477,12895,1284,451,99,53,17090,1181,1128,2309,2115,935,1180,7396,40,NA
12043,"Glades County, Florida",12179,6794,5385,23296,9569,912,262,50,18,10995,1182,1113,2295,2382,936,1446,3425,84,NA
12045,"Gulf County, Florida",15002,8629,6373,30011,11873,1515,783,186,57,12388,707,443,1150,1522,654,868,5106,129,NA
12047,"Hamilton County, Florida",13492,7721,5771,17331,9968,667,217,26,11,10850,773,861,1634,2822,1158,1664,3588,140,NA
12049,"Hardee County, Florida",25528,14055,11473,23380,16581,1169,462,76,11,23921,2036,1423,3459,6731,2905,3826,8845,39,NA
12051,"Hendry County, Florida",39902,21905,17997,24825,25602,1947,494,113,130,39185,4973,3516,8489,8729,4726,4003,17935,439,0
12053,"Hernando County, Florida",196621,95719,100902,31516,147268,19903,6999,1793,763,194692,12717,11731,24448,24134,10888,13246,77385,981,0
12055,"Highlands County, Florida",102339,50232,52107,31864,79094,9422,3200,1315,524,100980,7071,6168,13239,15742,7370,8372,34686,429,0
12057,"Hillsborough County, Florida",1468560,724235,744325,39509,1009935,231039,95352,25594,14067,1454485,94806,78597,173403,197369,88280,109089,723695,8062,35
12059,"Holmes County, Florida",19529,10451,9078,22860,14115,1089,354,79,32,17808,1734,1169,2903,2949,1294,1655,7533,32,NA
12061,"Indian River County, Florida",160986,78378,82608,44102,125938,25090,11578,3125,1421,159187,9867,7873,17740,18221,8620,9601,62037,942,0
12063,"Jackson County, Florida",47704,25869,21835,23210,34854,2905,1508,217,207,41223,2141,1896,4037,7787,3351,4436,16059,169,NA
12065,"Jefferson County, Florida",14458,7453,7005,29189,10826,1428,434,172,81,13232,570,752,1322,2414,951,1463,5936,30,NA
12067,"Lafayette County, Florida",8107,4919,3188,20073,5864,332,95,25,22,6710,708,302,1010,1306,630,676,2894,75,NA
12069,"Lake County, Florida",386829,188572,198257,35150,287099,46866,21265,2981,2608,382883,21371,18298,39669,36977,14910,22067,160502,2118,NA
12071,"Lee County, Florida",772902,380685,392217,41332,583335,108170,46394,13120,8033,767728,55651,42991,98642,89142,40124,49018,326302,4927,16
12073,"Leon County, Florida",294128,139638,154490,36823,175063,46636,22742,7247,6560,290471,13113,10845,23958,53940,24548,29392,147179,1118,0
12075,"Levy County, Florida",43268,21126,22142,29042,31811,3561,1212,262,87,42985,3463,3239,6702,6718,3096,3622,16885,68,NA
12077,"Liberty County, Florida",7704,4317,3387,24080,5516,518,346,43,22,6314,356,326,682,1375,567,808,2492,0,NA
12079,"Madison County, Florida",17986,9439,8547,22760,13709,1204,478,51,43,16123,1225,842,2067,3611,1709,1902,6020,89,NA
12081,"Manatee County, Florida",405069,196808,208261,41760,306549,61199,28098,6754,4595,400953,25442,23182,48624,40670,18396,22274,172752,2289,0
12083,"Marion County, Florida",378225,182704,195521,31086,281911,39294,16564,4119,2012,370052,23719,22349,46068,52923,23596,29327,139755,1513,0
12085,"Martin County, Florida",159399,78808,80591,50748,123856,27796,10503,3577,1594,156181,8837,6205,15042,16391,7808,8583,65741,1038,NA
12086,"Miami-Dade County, Florida",2688237,1318559,1369678,35563,1918837,388029,148779,63254,24268,2663981,217619,182896,400515,403997,177461,226536,1319578,19567,340
12087,"Monroe County, Florida",82044,42677,39367,54630,64245,14115,6494,1776,957,79954,6873,5407,12280,9480,4655,4825,42929,760,0
12089,"Nassau County, Florida",91538,45302,46236,44483,67839,13840,5948,970,953,90308,3674,3465,7139,8343,3642,4701,41279,386,0
12091,"Okaloosa County, Florida",212021,107993,104028,40002,146005,30071,14455,2537,1519,197145,12501,10009,22510,20998,10084,10914,104566,714,0
12093,"Okeechobee County, Florida",39870,21440,18430,26904,28352,3190,1316,234,33,37239,3924,2729,6653,7113,3167,3946,15091,218,NA
12095,"Orange County, Florida",1427403,704643,722760,37330,966029,231437,92629,24106,12649,1415086,94373,84516,178889,187454,85078,102376,717790,9955,15
12097,"Osceola County, Florida",393745,195519,198226,28690,261881,47040,17033,3258,2109,391862,25212,20928,46140,52441,24425,28016,187046,1678,8
12099,"Palm Beach County, Florida",1494805,729568,765237,48121,1099423,258721,109438,40362,17597,1480607,110500,89659,200159,166938,71962,94976,682181,10640,34
12101,"Pasco County, Florida",569211,278905,290306,35201,411953,72486,29212,5417,4580,562836,34475,28299,62774,66197,29417,36780,242883,3576,0
12103,"Pinellas County, Florida",959918,464021,495897,44020,745450,167442,65135,18687,10191,944372,57041,44629,101670,107865,48871,58994,454923,6160,6
12105,"Polk County, Florida",736229,363269,372960,30262,509692,73601,26530,5072,4082,727324,50331,44054,94385,106728,48042,58686,315558,3829,9
12107,"Putnam County, Florida",73604,36564,37040,25966,52656,4890,1636,229,261,72494,6859,5157,12016,16506,7115,9391,25550,136,NA
12109,"St. Johns County, Florida",278722,136822,141900,52096,198819,58157,26225,6130,3644,276769,10424,9402,19826,18720,8905,9815,128385,1562,0
12111,"St. Lucie County, Florida",334682,164702,169980,33847,244780,40046,15220,3356,2626,331993,21501,20260,41761,41337,17371,23966,142823,1172,8
12113,"Santa Rosa County, Florida",188994,97011,91983,39143,133200,25825,11127,1613,1263,178618,10336,9121,19457,16407,7421,8986,83822,1202,NA
12115,"Sarasota County, Florida",439392,210554,228838,53149,352738,77261,40346,10996,6452,433749,22578,21846,44424,35122,14912,20210,178719,1523,5
12117,"Seminole County, Florida",471321,229821,241500,42281,334044,90716,35330,8294,5046,467795,25159,21956,47115,44796,20066,24730,243840,2914,0
12119,"Sumter County, Florida",131832,65425,66407,44431,118708,23971,12501,2228,1293,123732,3735,3656,7391,11443,4284,7159,27879,1429,NA
12121,"Suwannee County, Florida",43881,22980,20901,24991,31122,2831,1730,197,184,42239,3260,2252,5512,5999,2893,3106,16938,92,NA
12123,"Taylor County, Florida",21421,12051,9370,26859,15853,1541,573,41,52,18402,720,780,1500,2777,1549,1228,6593,64,NA
12125,"Union County, Florida",15524,10059,5465,24293,11097,679,320,42,72,10482,647,547,1194,1656,691,965,4225,19,NA
12127,"Volusia County, Florida",558520,274078,284442,35364,414960,71226,26115,6712,4475,551216,35300,28452,63752,66328,29739,36589,241735,3070,5
12129,"Wakulla County, Florida",33732,18653,15079,31683,24288,2917,1479,251,149,30846,1112,1053,2165,1888,1006,882,15067,78,NA
12131,"Walton County, Florida",76618,38843,37775,45348,56427,12778,4113,1176,637,74881,5977,4169,10146,7898,3610,4288,33781,338,NA
12133,"Washington County, Florida",25014,13312,11702,23984,18230,1302,637,234,88,22364,1679,1552,3231,5046,2343,2703,8533,63,NA
13001,"Appling County, Georgia",18441,9309,9132,23940,12283,676,422,90,43,18081,1231,1348,2579,4577,2297,2280,7195,262,NA
13003,"Atkinson County, Georgia",8265,4082,4183,23066,5468,306,187,63,65,8236,1122,795,1917,2266,1154,1112,3523,107,NA
13005,"Bacon County, Georgia",11138,5525,5613,24654,7324,373,243,158,25,10549,923,704,1627,2278,1154,1124,4213,51,NA
13007,"Baker County, Georgia",2878,1450,1428,23731,2055,227,158,0,5,2878,168,310,478,666,320,346,875,0,NA
13009,"Baldwin County, Georgia",43778,22148,21630,31681,27849,3770,1794,562,405,41217,2940,2149,5089,8864,4156,4708,16374,355,NA
13011,"Banks County, Georgia",18381,9338,9043,30024,12937,1372,518,166,159,18370,1347,1162,2509,2411,1232,1179,8321,12,NA
13013,"Barrow County, Georgia",84399,41722,42677,30899,55726,7743,2749,512,796,84157,7347,6197,13544,8009,3648,4361,40978,350,0
13015,"Bartow County, Georgia",109410,54685,54725,32102,73182,10517,3359,917,599,108314,7726,7299,15025,11700,5784,5916,51272,163,NA
13017,"Ben Hill County, Georgia",17169,8075,9094,22625,11502,1003,256,103,41,16814,1577,1543,3120,4442,1720,2722,7099,48,NA
13019,"Berrien County, Georgia",18187,9046,9141,25100,12433,1211,408,109,116,17929,2033,1869,3902,4167,1802,2365,7206,26,NA
13021,"Bibb County, Georgia",156554,73881,82673,30115,103131,13738,8300,3235,1394,153328,11377,9882,21259,37641,15901,21740,63811,489,NA
13023,"Bleckley County, Georgia",12413,6042,6371,28207,8151,897,373,99,144,12012,426,682,1108,1906,837,1069,4963,96,NA
13025,"Brantley County, Georgia",18105,8970,9135,22767,12582,589,492,210,8,18035,1839,1027,2866,2933,1288,1645,6865,72,NA
13027,"Brooks County, Georgia",16275,7883,8392,28004,11428,1114,386,88,89,16113,1730,1249,2979,4277,1886,2391,6521,17,NA
13029,"Bryan County, Georgia",44995,22481,22514,39829,28192,5989,2902,458,209,43080,2127,1564,3691,3200,1414,1786,21534,246,NA
13031,"Bulloch County, Georgia",79829,38876,40953,28484,45038,8064,3361,655,1264,79206,4569,4831,9400,16576,7721,8855,34969,517,NA
13033,"Burke County, Georgia",24337,11944,12393,29735,15584,1667,420,78,119,24134,1319,1190,2509,4150,1976,2174,10318,228,NA
13035,"Butts County, Georgia",25522,13710,11812,27875,17892,1494,506,245,92,23025,1278,1302,2580,3612,1597,2015,10025,89,NA
13037,"Calhoun County, Georgia",5594,3461,2133,18074,4212,295,156,26,2,3900,370,241,611,1007,351,656,1574,0,NA
13039,"Camden County, Georgia",55105,28750,26355,32712,35521,4874,2136,395,289,51099,2314,2369,4683,8638,3680,4958,25574,120,NA
13043,"Candler County, Georgia",10946,5334,5612,24477,7318,590,215,84,6,10648,1155,1017,2172,1947,977,970,4429,55,NA
13045,"Carroll County, Georgia",120060,58690,61370,30827,76484,10252,4142,1362,483,118981,8205,6348,14553,19641,8711,10930,54488,554,NA
13047,"Catoosa County, Georgia",68052,33371,34681,33515,47530,6953,2969,874,248,67544,4189,3139,7328,6012,2379,3633,32259,207,NA
13049,"Charlton County, Georgia",12547,7331,5216,22742,9002,870,91,115,16,11689,1513,591,2104,2381,918,1463,4961,43,NA
13051,"Chatham County, Georgia",296266,142685,153581,37637,202409,43032,20645,5609,3727,288174,20471,18612,39083,39871,17490,22381,143265,1718,NA
13053,"Chattahoochee County, Georgia",9402,6090,3312,23574,4448,866,407,48,14,4758,104,133,237,908,411,497,5719,73,NA
13055,"Chattooga County, Georgia",24902,12763,12139,21576,17279,950,519,137,31,23308,1753,1268,3021,4593,2126,2467,8879,25,NA
13057,"Cherokee County, Georgia",268567,132996,135571,45334,183322,50928,16362,3083,2037,267246,15447,14283,29730,17662,7455,10207,139111,815,NA
13059,"Clarke County, Georgia",128864,61390,67474,30138,73265,17848,10644,2200,4437,127922,7913,7994,15907,31528,13960,17568,62244,352,NA
13061,"Clay County, Georgia",2855,1335,1520,22191,1931,190,84,39,7,2798,152,135,287,720,262,458,1101,51,NA
13063,"Clayton County, Georgia",296312,139076,157236,25549,185573,25582,9258,2199,1204,293120,27514,25660,53174,49313,19623,29690,134762,1180,0
13065,"Clinch County, Georgia",6713,3337,3376,20294,4511,412,126,36,7,6621,892,506,1398,2149,1068,1081,2512,156,NA
13067,"Cobb County, Georgia",765813,373782,392031,48510,519750,163719,69825,15403,9350,760672,48108,46184,94292,62536,28229,34307,401114,5368,0
13069,"Coffee County, Georgia",43056,22197,20859,23839,28579,2268,885,340,190,40774,4142,3122,7264,8063,3330,4733,17589,840,NA
13071,"Colquitt County, Georgia",45813,22969,22844,25766,29871,2315,1432,452,195,45366,5516,4491,10007,11024,5409,5615,19065,278,NA
13073,"Columbia County, Georgia",156921,76942,79979,40677,104791,22587,10563,3422,2651,153471,6453,6874,13327,11234,4973,6261,75125,443,NA
13075,"Cook County, Georgia",17242,8337,8905,24060,11189,1087,639,51,14,16911,1624,1582,3206,3694,1298,2396,7706,67,NA
13077,"Coweta County, Georgia",147449,71903,75546,41373,100309,21935,8631,2296,1390,146708,6567,6553,13120,12209,5159,7050,72084,1510,0
13079,"Crawford County, Georgia",12156,6358,5798,31240,8525,503,415,25,18,12010,940,863,1803,1987,779,1208,4844,103,NA
13081,"Crisp County, Georgia",20255,10171,10084,28063,13661,1157,379,338,51,19875,1808,1477,3285,4648,2163,2485,8315,87,NA
13083,"Dade County, Georgia",16239,8015,8224,30078,11294,1474,487,89,18,16101,920,992,1912,985,424,561,6928,30,NA
13085,"Dawson County, Georgia",27355,14023,13332,41096,19579,4797,1360,615,171,27151,2128,1648,3776,2623,1255,1368,13367,101,NA
13087,"Decatur County, Georgia",29063,14097,14966,24974,19270,1893,618,243,134,27928,2097,2265,4362,6805,2798,4007,10902,164,NA
13089,"DeKalb County, Georgia",761209,361801,399408,43958,522568,137065,71794,19885,15077,755794,54239,45843,100082,100326,44113,56213,378641,3265,0
13091,"Dodge County, Georgia",19977,10501,9476,23137,14411,1400,500,203,22,18442,1723,996,2719,4090,1748,2342,7620,221,NA
13093,"Dooly County, Georgia",11236,6299,4937,27232,8557,763,270,21,62,9304,1034,609,1643,1942,932,1010,3902,21,NA
13095,"Dougherty County, Georgia",85038,39219,45819,26563,55209,7102,3665,1116,976,83147,6363,6337,12700,21493,9399,12094,32937,367,NA
13097,"Douglas County, Georgia",144735,69255,75480,34010,93905,17347,8159,1578,957,143335,8970,8613,17583,16579,7617,8962,69337,934,NA
13099,"Early County, Georgia",10753,5082,5671,25929,6854,621,233,63,42,10589,845,804,1649,2356,864,1492,4220,93,NA
13101,"Echols County, Georgia",3707,1703,2004,24751,2271,195,109,8,5,3707,381,541,922,555,154,401,1901,0,NA
13103,"Effingham County, Georgia",65314,32382,32932,36506,42691,7658,2333,484,278,64647,3093,3068,6161,4290,2063,2227,30689,142,0
13105,"Elbert County, Georgia",19570,9358,10212,27848,13921,1180,492,243,43,19302,1192,1130,2322,3653,1253,2400,8440,44,NA
13107,"Emanuel County, Georgia",22907,11621,11286,24696,15273,1174,315,176,108,22045,2181,1507,3688,4674,2166,2508,8865,138,NA
13109,"Evans County, Georgia",10759,5425,5334,25580,6975,731,292,97,21,10257,825,855,1680,2177,997,1180,4262,147,NA
13111,"Fannin County, Georgia",25436,12481,12955,36058,19858,2598,1143,416,451,25286,2397,1656,4053,2973,1237,1736,9711,95,NA
13113,"Fayette County, Georgia",119259,58066,61193,51004,81529,23851,10848,2241,1579,118389,4606,4837,9443,6226,2283,3943,54097,1346,NA
13115,"Floyd County, Georgia",98541,48250,50291,30523,65521,8512,3799,1525,782,96514,7510,6476,13986,16534,7538,8996,42651,475,NA
13117,"Forsyth County, Georgia",253225,126773,126452,54002,165931,58027,28330,4024,2864,252422,10829,8865,19694,11591,5229,6362,128130,1021,0
13119,"Franklin County, Georgia",23480,11680,11800,27671,15957,1587,746,260,95,23261,2230,1794,4024,4162,2041,2121,9404,46,NA
13121,"Fulton County, Georgia",1061944,518219,543725,58314,730654,242267,125451,31693,17457,1051899,56208,50805,107013,128777,56570,72207,551789,8310,7
13123,"Gilmer County, Georgia",31519,15692,15827,34412,23455,3307,1508,521,156,31364,2813,2300,5113,4634,2294,2340,13217,84,NA
13125,"Glascock County, Georgia",2903,1326,1577,28733,1987,232,25,0,0,2819,205,82,287,438,214,224,1286,2,NA
13127,"Glynn County, Georgia",84566,39461,45105,39221,60152,10955,5366,1449,649,83516,6648,5191,11839,13638,5922,7716,36929,402,0
13129,"Gordon County, Georgia",57785,28644,29141,29787,39102,3675,2092,490,266,57263,4761,4699,9460,8014,3361,4653,26088,25,NA
13131,"Grady County, Georgia",26075,12816,13259,26887,17685,1671,633,282,211,25906,2702,2611,5313,5121,2174,2947,10600,110,NA
13133,"Greene County, Georgia",19020,9398,9622,51577,14155,3029,1181,355,166,18861,1993,1391,3384,2434,971,1463,7261,60,NA
13135,"Gwinnett County, Georgia",957977,470667,487310,36778,613696,154792,62531,11835,9631,953145,75168,67132,142300,96291,44384,51907,464985,4084,10
13137,"Habersham County, Georgia",46326,22076,24250,29069,31309,4024,2166,601,392,44698,3542,3316,6858,5942,2479,3463,20660,67,NA
13139,"Hall County, Georgia",204953,102512,102441,35624,135246,21466,7824,3143,2048,203764,19632,15919,35551,27392,12569,14823,97489,800,NA
13141,"Hancock County, Georgia",8588,4502,4086,19730,6597,538,52,21,24,7073,376,406,782,1932,560,1372,2445,106,NA
13143,"Haralson County, Georgia",30178,14860,15318,31342,20766,2281,790,379,260,29909,1831,1598,3429,3737,1802,1935,13781,144,NA
13145,"Harris County, Georgia",34914,17698,17216,39851,24553,4385,2571,547,457,34204,1344,946,2290,2588,1271,1317,15595,48,NA
13147,"Hart County, Georgia",26110,12979,13131,30636,19076,2482,704,140,157,25308,1662,1232,2894,2742,1345,1397,10998,50,NA
13149,"Heard County, Georgia",11489,5718,5771,32386,7848,602,164,126,19,11353,917,687,1604,1887,792,1095,4470,9,NA
13151,"Henry County, Georgia",240853,115211,125642,35065,156722,28106,11691,1915,1372,239301,11745,12807,24552,20180,8710,11470,115681,742,NA
13153,"Houston County, Georgia",164117,79890,84227,35223,107796,19718,10967,2292,1522,158581,8443,8126,16569,15791,7363,8428,78041,803,NA
13155,"Irwin County, Georgia",9487,4957,4530,23794,6529,551,312,170,65,9233,1064,870,1934,2028,1083,945,3897,46,NA
13157,"Jackson County, Georgia",77033,38539,38494,34703,52021,9536,3152,877,233,76325,4637,4328,8965,6198,2803,3395,36440,273,NA
13159,"Jasper County, Georgia",14882,7274,7608,31026,10251,1036,572,175,93,14757,1119,711,1830,1963,948,1015,6326,97,NA
13161,"Jeff Davis County, Georgia",14791,7389,7402,22065,9717,814,207,74,23,14711,1820,1472,3292,3326,1279,2047,5757,194,NA
13163,"Jefferson County, Georgia",15591,7582,8009,25820,10550,794,277,68,2,15139,1395,1097,2492,2925,1204,1721,6165,93,NA
13165,"Jenkins County, Georgia",8704,4357,4347,19360,6607,326,178,84,10,7919,716,713,1429,2163,1167,996,2859,63,NA
13167,"Johnson County, Georgia",9225,5556,3669,23878,6644,276,269,61,25,8072,605,375,980,1762,793,969,3175,28,NA
13169,"Jones County, Georgia",28382,13905,14477,31934,19675,2276,768,416,59,28094,1643,786,2429,4016,2017,1999,12627,97,NA
13171,"Lamar County, Georgia",18676,9112,9564,30978,12272,1122,575,272,177,18432,1123,846,1969,1967,811,1156,7952,200,NA
13173,"Lanier County, Georgia",9964,4880,5084,22128,6569,744,405,27,34,9309,652,899,1551,3114,1483,1631,3781,30,NA
13175,"Laurens County, Georgia",49407,23587,25820,27565,33167,2907,2088,483,186,48634,3151,3404,6555,11823,5001,6822,19037,164,NA
13177,"Lee County, Georgia",32968,16560,16408,34074,21270,4222,2003,507,210,31862,1353,952,2305,2802,1270,1532,15619,83,NA
13179,"Liberty County, Georgia",65550,33739,31811,26121,37758,5266,1829,303,237,58442,3860,2808,6668,9676,3841,5835,29627,235,NA
13181,"Lincoln County, Georgia",7726,3794,3932,28414,5695,584,240,81,20,7639,542,504,1046,1388,746,642,3162,41,NA
13183,"Long County, Georgia",16804,8679,8125,26995,10800,848,282,106,164,15939,1070,1009,2079,2594,939,1655,7445,96,NA
13185,"Lowndes County, Georgia",118257,57335,60922,27553,70095,11039,4893,1157,1196,112686,8574,8504,17078,23507,10312,13195,52388,729,NA
13187,"Lumpkin County, Georgia",33405,16346,17059,33322,20748,3938,1549,744,414,33045,1547,1934,3481,4556,1894,2662,15172,135,0
13189,"McDuffie County, Georgia",21715,10508,11207,28259,14705,1489,853,155,206,21469,1292,1090,2382,3430,1389,2041,9457,90,NA
13191,"McIntosh County, Georgia",11183,5518,5665,28773,8928,1052,315,129,94,11074,776,788,1564,2240,1013,1227,4519,7,NA
13193,"Macon County, Georgia",12099,6604,5495,22681,8627,515,263,30,60,10104,1382,1030,2412,2651,1001,1650,3533,52,NA
13195,"Madison County, Georgia",30378,14705,15673,27769,20802,2002,1657,276,140,30162,2785,2454,5239,6203,2460,3743,12960,96,NA
13197,"Marion County, Georgia",7508,3680,3828,24727,5391,509,130,18,0,7413,755,497,1252,916,344,572,2806,6,NA
13199,"Meriwether County, Georgia",20679,9966,10713,25784,14753,1186,533,107,110,20556,1409,1682,3091,4540,1883,2657,7732,34,NA
13201,"Miller County, Georgia",5923,2792,3131,29135,4072,461,206,67,67,5765,511,442,953,1411,573,838,2382,11,NA
13205,"Mitchell County, Georgia",21634,11195,10439,24705,14690,933,432,215,225,19690,1944,1882,3826,5658,2018,3640,7509,25,NA
13207,"Monroe County, Georgia",28287,14308,13979,40063,19809,3120,1579,589,369,27111,1818,1539,3357,3708,1824,1884,12742,106,NA
13209,"Montgomery County, Georgia",8687,4405,4282,27994,5719,606,334,109,71,8218,471,731,1202,1312,526,786,3395,47,NA
13211,"Morgan County, Georgia",20171,9990,10181,38932,14369,2519,1193,378,203,19993,930,788,1718,1715,642,1073,9658,65,NA
13213,"Murray County, Georgia",40063,19928,20135,27383,27036,2039,733,185,112,39779,2900,2732,5632,5165,2113,3052,17719,16,NA
13215,"Muscogee County, Georgia",204572,98973,105599,30980,134389,22117,11663,2703,1711,194634,11916,11487,23403,37204,16777,20427,88082,1580,NA
13217,"Newton County, Georgia",113298,53614,59684,30101,73089,9900,5151,831,620,112402,7244,8076,15320,14935,6646,8289,52493,1183,NA
13219,"Oconee County, Georgia",41978,20864,21114,53848,27475,7238,4192,1813,1445,41776,1406,1609,3015,1862,823,1039,20456,266,NA
13221,"Oglethorpe County, Georgia",14974,7528,7446,30225,10536,1411,644,159,174,14812,988,854,1842,1646,740,906,6959,69,NA
13223,"Paulding County, Georgia",169898,83341,86557,35242,111586,19595,7793,1164,1068,168895,9852,8557,18409,11309,5098,6211,82606,565,NA
13225,"Peach County, Georgia",28054,13785,14269,31349,18005,2061,1662,264,136,27904,1966,1125,3091,5463,2160,3303,11644,130,NA
13227,"Pickens County, Georgia",33439,16763,16676,37686,24627,3942,1461,311,266,33148,2275,1844,4119,4469,2036,2433,15293,81,NA
13229,"Pierce County, Georgia",19822,9942,9880,26392,13247,1244,769,216,23,19622,1196,1556,2752,2992,1447,1545,8446,20,NA
13231,"Pike County, Georgia",19145,9417,9728,35993,13056,1489,712,259,171,18907,1386,1194,2580,1531,615,916,8480,42,NA
13233,"Polk County, Georgia",43019,21203,21816,26843,28540,2561,949,363,224,42689,2996,3072,6068,7337,3490,3847,17896,313,NA
13235,"Pulaski County, Georgia",9887,4339,5548,23007,7360,603,257,61,27,8610,443,400,843,1627,752,875,3555,0,NA
13237,"Putnam County, Georgia",22206,10855,11351,42468,16260,2654,1002,442,64,21943,1285,1422,2707,3528,1178,2350,9295,123,NA
13239,"Quitman County, Georgia",2180,1179,1001,22189,1690,118,67,0,0,2180,360,148,508,333,212,121,525,0,NA
13241,"Rabun County, Georgia",16915,8264,8651,35889,13158,2052,1244,265,129,16683,1115,1157,2272,2397,1064,1333,6735,63,NA
13243,"Randolph County, Georgia",6365,2939,3426,18208,4233,404,98,5,19,6273,369,322,691,1739,701,1038,2390,23,NA
13245,"Richmond County, Georgia",206153,99791,106362,28480,135577,19289,8118,3033,1496,194852,12129,11278,23407,40606,16419,24187,91150,3437,NA
13247,"Rockdale County, Georgia",93641,44495,49146,33481,62583,10631,5252,1088,631,92845,7004,6727,13731,10539,4256,6283,42514,677,NA
13249,"Schley County, Georgia",4565,2309,2256,24255,3019,302,152,43,45,4565,311,353,664,727,333,394,1857,48,NA
13251,"Screven County, Georgia",14026,6742,7284,28356,10250,844,537,133,98,13674,784,756,1540,2511,881,1630,5799,68,NA
13253,"Seminole County, Georgia",9117,4425,4692,36184,6698,741,266,77,55,9003,836,817,1653,1890,687,1203,3239,69,NA
13255,"Spalding County, Georgia",67415,32327,35088,35823,46186,5262,2386,545,267,66365,4741,3914,8655,12412,5465,6947,27798,275,NA
13257,"Stephens County, Georgia",26732,12685,14047,26620,18319,1777,654,287,212,26660,1983,2111,4094,3289,1258,2031,11191,13,NA
13259,"Stewart County, Georgia",5121,3538,1583,21096,4182,467,163,13,18,3391,483,76,559,746,483,263,1450,0,NA
13261,"Sumter County, Georgia",29378,13782,15596,23891,18489,2616,963,148,373,28616,1459,1927,3386,6666,2923,3743,11843,157,NA
13263,"Talbot County, Georgia",5793,2802,2991,28528,4411,435,210,9,25,5765,439,336,775,1057,481,576,2420,69,NA
13265,"Taliaferro County, Georgia",1635,734,901,24766,1300,86,28,18,17,1630,109,95,204,308,163,145,670,2,NA
13267,"Tattnall County, Georgia",24309,14137,10172,21842,16973,1288,787,224,73,19245,1357,1560,2917,3864,1543,2321,7609,498,NA
13269,"Taylor County, Georgia",7799,3741,4058,24453,5518,566,287,33,15,7655,506,384,890,2211,1024,1187,2827,8,NA
13271,"Telfair County, Georgia",12619,7534,5085,17162,8699,321,269,79,31,10079,333,875,1208,3138,1675,1463,3676,11,NA
13273,"Terrell County, Georgia",9004,4532,4472,24200,6081,396,336,48,9,8628,920,651,1571,2589,1314,1275,3275,56,NA
13275,"Thomas County, Georgia",45665,21757,23908,32414,31127,4882,1754,460,319,45159,2904,2775,5679,8420,3683,4737,20528,48,NA
13277,"Tift County, Georgia",41247,20002,21245,27987,26945,2594,1618,492,339,40637,3085,3726,6811,8245,3447,4798,17682,167,NA
13279,"Toombs County, Georgia",26946,12819,14127,27912,17297,1511,1063,184,73,26646,2817,1703,4520,5760,2472,3288,9940,29,NA
13281,"Towns County, Georgia",12546,6034,6512,33443,9554,1754,779,247,276,12383,898,894,1792,1786,897,889,4510,17,NA
13283,"Treutlen County, Georgia",6411,3409,3002,27309,4336,480,84,20,10,6070,570,313,883,1700,735,965,2163,0,NA
13285,"Troup County, Georgia",69527,33108,36419,29562,46260,5486,2474,888,547,68165,3570,3416,6986,13008,5794,7214,30516,271,NA
13287,"Turner County, Georgia",8894,4308,4586,21771,6043,453,123,43,16,8684,717,484,1201,1928,682,1246,3301,7,NA
13289,"Twiggs County, Georgia",7955,3881,4074,32105,6030,392,154,52,44,7871,407,411,818,1232,621,611,2727,49,NA
13291,"Union County, Georgia",24880,12345,12535,37709,19586,3047,1251,466,228,24305,1660,1119,2779,2845,1297,1548,9400,57,NA
13293,"Upson County, Georgia",27638,13285,14353,27906,19052,1873,740,233,83,27167,1732,1602,3334,6007,2271,3736,11247,44,NA
13295,"Walker County, Georgia",68065,33912,34153,28554,47811,5968,2356,476,604,66591,4992,3916,8908,9114,4184,4930,29901,217,NA
13297,"Walton County, Georgia",97752,47777,49975,34295,65681,9940,4482,1021,503,96813,5768,6013,11781,12597,5308,7289,45662,727,0
13299,"Ware County, Georgia",35917,17975,17942,23319,24173,2561,717,242,139,33708,3415,2496,5911,7920,3277,4643,12933,143,NA
13301,"Warren County, Georgia",5197,2405,2792,24249,3692,260,120,14,14,5122,303,140,443,1175,551,624,1993,111,NA
13303,"Washington County, Georgia",19975,10209,9766,23687,14066,1756,480,183,32,18193,1491,999,2490,3045,1322,1723,7422,54,NA
13305,"Wayne County, Georgia",30277,15113,15164,24838,20263,1713,702,358,89,28388,3076,2386,5462,5150,2022,3128,10946,98,NA
13307,"Webster County, Georgia",2354,1208,1146,22246,1709,129,26,4,0,2350,374,203,577,655,372,283,958,0,NA
13309,"Wheeler County, Georgia",7550,4975,2575,17980,4792,557,46,7,1,6968,1292,385,1677,1856,1060,796,2736,14,NA
13311,"White County, Georgia",28165,13898,14267,32311,19922,2647,1400,341,219,27981,1684,1665,3349,3561,1479,2082,12478,267,NA
13313,"Whitfield County, Georgia",103033,51768,51265,28594,66792,7260,3540,1235,373,102200,9633,8739,18372,13695,6024,7671,47067,286,NA
13315,"Wilcox County, Georgia",8839,5344,3495,19237,6487,455,278,139,12,7021,787,398,1185,1608,701,907,2847,126,NA
13317,"Wilkes County, Georgia",9610,4947,4663,29042,7015,839,145,104,9,9510,1143,724,1867,1694,930,764,3867,35,NA
13319,"Wilkinson County, Georgia",8852,4233,4619,24070,6122,494,184,10,50,8758,519,599,1118,1896,803,1093,3231,5,NA
13321,"Worth County, Georgia",20706,9859,10847,28119,14450,950,323,60,41,20529,1840,1601,3441,3982,1490,2492,8629,161,NA
16001,"Ada County, Idaho",497494,251101,246393,44645,340007,94823,35986,8633,5946,488475,19298,14836,34134,42460,20148,22312,252218,2392,0
16003,"Adams County, Idaho",4464,2305,2159,35844,3489,436,252,53,2,4440,272,281,553,645,267,378,1708,3,NA
16005,"Bannock County, Idaho",87434,44037,43397,30257,55903,10949,3720,653,1175,86326,3644,3136,6780,10541,5069,5472,38777,297,NA
16007,"Bear Lake County, Idaho",6436,3243,3193,30266,4244,604,226,9,43,6374,155,224,379,671,317,354,2644,13,NA
16009,"Benewah County, Idaho",9731,4996,4735,28420,6892,883,262,61,76,9618,758,581,1339,1390,634,756,3734,55,NA
16011,"Bingham County, Idaho",48253,24367,23886,29421,29380,4176,1200,259,197,47770,2865,1825,4690,4939,2581,2358,21253,64,NA
16013,"Blaine County, Idaho",24248,12648,11600,47151,17446,5439,1715,495,119,24178,1564,1402,2966,1674,838,836,13268,161,0
16015,"Boise County, Idaho",7809,3907,3902,36518,6136,1079,287,181,115,7762,524,517,1041,733,279,454,3322,0,NA
16017,"Bonner County, Idaho",47976,24159,23817,35275,35969,6500,2311,689,271,47581,2361,2324,4685,5621,2624,2997,19490,179,NA
16019,"Bonneville County, Idaho",124490,62477,62013,33008,75960,16371,5481,1138,1225,123100,6300,4687,10987,11641,4881,6760,55030,580,0
16021,"Boundary County, Idaho",12335,6230,6105,27287,8561,952,388,148,66,12175,908,555,1463,2247,995,1252,4743,4,NA
16023,"Butte County, Idaho",2605,1305,1300,26987,1873,232,65,6,1,2566,106,87,193,568,213,355,1047,6,NA
16025,"Camas County, Idaho",1133,559,574,34790,733,136,51,9,2,1133,65,55,120,76,35,41,465,2,NA
16027,"Canyon County, Idaho",235006,117340,117666,28569,147654,22406,6782,1747,953,233243,14893,13123,28016,23412,10425,12987,106912,1178,NA
16029,"Caribou County, Idaho",7058,3704,3354,29819,4501,454,187,21,43,6964,363,307,670,468,260,208,3337,42,NA
16031,"Cassia County, Idaho",24859,12741,12118,28986,14855,2163,711,125,45,24500,1715,1022,2737,2536,1309,1227,11236,175,NA
16033,"Clark County, Idaho",756,387,369,24370,498,54,21,0,1,753,89,89,178,69,42,27,401,0,NA
16035,"Clearwater County, Idaho",8810,4912,3898,29925,7082,872,291,76,43,8000,616,451,1067,900,420,480,3299,75,NA
16037,"Custer County, Idaho",4344,2286,2058,28913,3457,814,136,42,3,4319,469,132,601,497,293,204,1762,32,NA
16039,"Elmore County, Idaho",28752,15367,13385,28599,18203,2806,718,240,32,25106,1781,1321,3102,3285,1561,1724,13077,54,NA
16041,"Franklin County, Idaho",14376,7425,6951,27316,8542,1007,344,79,40,14323,971,604,1575,1367,615,752,6423,19,NA
16043,"Fremont County, Idaho",13519,7028,6491,27427,9060,1526,287,38,86,13030,859,887,1746,1484,562,922,5718,42,NA
16045,"Gem County, Idaho",19250,9776,9474,33032,13550,2476,420,101,45,19022,1067,1229,2296,2204,1083,1121,8321,58,NA
16047,"Gooding County, Idaho",15520,7917,7603,29147,10051,1123,370,17,78,15433,1762,1190,2952,2043,803,1240,7018,127,NA
16049,"Idaho County, Idaho",16787,8835,7952,29657,12470,2059,406,104,107,16252,1418,1234,2652,1688,825,863,6403,87,NA
16051,"Jefferson County, Idaho",31383,16051,15332,29028,18071,3264,1298,131,145,31304,1695,1308,3003,2791,1327,1464,14151,151,NA
16053,"Jerome County, Idaho",24474,12576,11898,28266,15020,1311,497,101,59,24317,1681,1819,3500,3571,1587,1984,11337,54,NA
16055,"Kootenai County, Idaho",173396,86516,86880,36718,121326,21597,7401,2249,1180,171875,9077,8156,17233,15857,6902,8955,80056,486,NA
16057,"Latah County, Idaho",39872,20524,19348,33342,23242,6316,2481,588,916,39628,1653,1118,2771,4751,2305,2446,18879,155,NA
16059,"Lemhi County, Idaho",8043,4228,3815,32446,6015,811,411,84,28,7918,355,193,548,846,347,499,3273,1,NA
16061,"Lewis County, Idaho",3630,1825,1805,27519,2619,329,115,21,20,3603,196,181,377,637,301,336,1307,12,NA
16063,"Lincoln County, Idaho",5203,2779,2424,27335,3410,217,103,35,27,5132,455,421,876,602,362,240,2514,5,NA
16065,"Madison County, Idaho",52487,23769,28718,21394,17543,4845,1406,229,371,52294,1499,1708,3207,13963,4159,9804,26209,18,NA
16067,"Minidoka County, Idaho",21626,10930,10696,29561,13452,1213,544,314,70,21564,1778,1429,3207,3229,1531,1698,9867,124,NA
16069,"Nez Perce County, Idaho",42200,21000,21200,35387,29485,5147,1468,280,673,41370,2511,1676,4187,5749,2607,3142,19581,80,NA
16071,"Oneida County, Idaho",4572,2315,2257,28592,2926,525,165,3,3,4522,137,182,319,611,229,382,2145,0,NA
16073,"Owyhee County, Idaho",12043,6238,5805,25106,8004,847,218,4,45,11913,1339,1106,2445,1560,787,773,5214,38,NA
16075,"Payette County, Idaho",25571,12729,12842,30102,17063,2481,726,154,78,25348,1430,948,2378,2663,1145,1518,10627,61,NA
16077,"Power County, Idaho",7918,3982,3936,24069,4837,473,177,43,17,7849,625,515,1140,875,426,449,3530,17,NA
16079,"Shoshone County, Idaho",13399,6666,6733,26176,9706,675,275,108,72,13189,1029,773,1802,2098,913,1185,5471,96,NA
16081,"Teton County, Idaho",11813,6046,5767,43396,8147,2754,830,205,47,11809,989,802,1791,1178,441,737,6681,23,NA
16083,"Twin Falls County, Idaho",90592,45073,45519,32393,58172,8180,3898,885,762,89629,5114,4422,9536,11126,5294,5832,41514,256,NA
16085,"Valley County, Idaho",11830,6165,5665,34544,9282,2184,789,272,134,11716,500,945,1445,1628,558,1070,4848,41,NA
16087,"Washington County, Idaho",10612,5264,5348,26213,7460,863,341,54,46,10436,587,702,1289,1894,745,1149,3897,32,NA
17001,"Adams County, Illinois",65583,32311,33272,34934,45657,8164,3268,517,344,64463,1642,1473,3115,7731,3027,4704,32863,282,NA
17003,"Alexander County, Illinois",5261,2561,2700,21922,3759,222,146,21,0,5164,281,288,569,1103,385,718,1797,47,NA
17005,"Bond County, Illinois",16750,8893,7857,29944,11499,1404,806,67,145,15324,368,304,672,2187,1101,1086,6913,29,NA
17007,"Boone County, Illinois",53459,26938,26521,37055,35284,5325,2364,561,220,53140,1618,1416,3034,5150,2403,2747,25158,101,NA
17009,"Brown County, Illinois",6334,3992,2342,25951,4604,496,127,13,10,4643,153,77,230,465,186,279,2368,6,NA
17011,"Bureau County, Illinois",33203,16455,16748,34873,23667,3356,1332,266,124,32811,1294,847,2141,4128,1891,2237,15611,128,NA
17013,"Calhoun County, Illinois",4472,2298,2174,33062,3272,452,140,23,24,4395,47,4,51,364,200,164,1746,13,NA
17015,"Carroll County, Illinois",15594,8383,7211,31882,11436,1553,481,52,50,14628,590,369,959,1641,830,811,6722,37,NA
17017,"Cass County, Illinois",12955,6557,6398,29842,8733,1249,366,37,28,12847,352,222,574,1577,627,950,5760,45,NA
17019,"Champaign County, Illinois",206525,103245,103280,35810,120366,24912,18368,3665,7970,205103,5900,4126,10026,35991,17271,18720,98994,684,NA
17021,"Christian County, Illinois",33893,17737,16156,29960,24101,2981,831,104,226,32320,983,447,1430,3816,1616,2200,14557,8,NA
17023,"Clark County, Illinois",15467,7715,7752,33341,10749,1790,726,74,35,15222,456,269,725,1371,606,765,7074,9,NA
17025,"Clay County, Illinois",13248,6650,6598,32495,9254,890,295,122,82,13073,478,355,833,2048,1005,1043,5711,8,NA
17027,"Clinton County, Illinois",36998,19318,17680,39409,26316,4352,1560,206,94,35158,1102,800,1902,2531,1357,1174,18038,55,NA
17029,"Coles County, Illinois",47076,23095,23981,32395,30496,4881,2404,461,481,46341,2036,1169,3205,8465,4028,4437,22724,120,NA
17031,"Cook County, Illinois",5225367,2554641,2670726,45646,3639978,874091,446799,118884,62940,5180534,258311,208206,466517,687906,302426,385480,2547260,27868,29
17033,"Crawford County, Illinois",18729,9989,8740,32786,13584,1669,769,79,53,17124,587,470,1057,1632,789,843,8191,29,NA
17035,"Cumberland County, Illinois",10447,5400,5047,34338,7407,884,375,36,19,10318,361,249,610,1000,507,493,5403,7,NA
17037,"DeKalb County, Illinois",100686,50029,50657,34196,59829,12450,6161,738,1032,99968,2632,1810,4442,14841,6948,7893,50485,480,NA
17039,"De Witt County, Illinois",15535,7822,7713,35630,11080,1586,575,154,66,15280,420,186,606,1557,701,856,7552,18,NA
17041,"Douglas County, Illinois",19714,9766,9948,32351,13255,1847,570,116,101,19516,1845,1501,3346,1833,690,1143,9387,79,NA
17043,"DuPage County, Illinois",930559,461287,469272,55107,642881,195110,97112,22698,13366,924076,26075,21757,47832,57674,25560,32114,480623,3798,5
17045,"Edgar County, Illinois",16852,8364,8488,31634,12383,1661,551,79,36,16508,518,327,845,1946,807,1139,7409,50,NA
17047,"Edwards County, Illinois",6182,3064,3118,31081,4338,436,134,6,27,6161,247,183,430,870,317,553,2655,43,NA
17049,"Effingham County, Illinois",34594,17394,17200,37844,23734,4213,1275,548,122,34218,983,814,1797,3680,1471,2209,17381,124,NA
17051,"Fayette County, Illinois",21464,11334,10130,28392,15207,1629,493,110,22,20363,1023,590,1613,2964,1440,1524,8886,56,NA
17053,"Ford County, Illinois",13484,6760,6724,31754,9337,1102,610,46,88,13097,591,277,868,1578,702,876,6338,34,NA
17055,"Franklin County, Illinois",37810,18902,18908,28310,26692,3286,1068,204,155,37342,1579,982,2561,6626,3021,3605,15486,115,NA
17057,"Fulton County, Illinois",33691,17528,16163,32378,24468,2980,1030,247,71,31665,839,488,1327,4223,2030,2193,14264,92,NA
17059,"Gallatin County, Illinois",4967,2498,2469,36928,3676,276,130,29,21,4958,95,47,142,950,398,552,2074,15,NA
17061,"Greene County, Illinois",12015,6050,5965,31536,8500,909,311,52,41,11764,392,257,649,1606,808,798,5447,47,NA
17063,"Grundy County, Illinois",52624,26702,25922,42192,35053,5864,2567,411,162,52287,933,866,1799,3114,1318,1796,26321,138,NA
17065,"Hamilton County, Illinois",8008,3965,4043,29785,5698,565,344,43,26,7942,388,167,555,1021,364,657,3243,12,NA
17067,"Hancock County, Illinois",17582,8916,8666,35154,12666,2154,738,133,86,17370,469,379,848,2272,1006,1266,8112,37,NA
17069,"Hardin County, Illinois",3665,1846,1819,31928,2986,201,97,44,17,3602,47,140,187,414,176,238,1210,15,NA
17071,"Henderson County, Illinois",6374,3194,3180,34734,4772,743,158,10,77,6318,78,57,135,575,234,341,2896,13,NA
17073,"Henry County, Illinois",49157,24530,24627,37212,34814,5767,2255,399,165,48484,1231,872,2103,4461,1988,2473,23067,223,NA
17075,"Iroquois County, Illinois",27043,13380,13663,33347,19152,2502,776,39,63,26654,825,739,1564,2823,1201,1622,12171,189,NA
17077,"Jackson County, Illinois",53176,26334,26842,29687,32045,5608,3479,955,1245,52686,2274,1469,3743,11449,5409,6040,22448,151,NA
17079,"Jasper County, Illinois",9295,4713,4582,33353,6488,972,351,50,14,9223,341,179,520,845,330,515,4584,59,NA
17081,"Jefferson County, Illinois",37043,19097,17946,30167,25881,2993,1300,285,117,35470,1478,1030,2508,4980,1914,3066,15993,70,NA
17083,"Jersey County, Illinois",21462,10512,10950,37352,15046,2037,885,205,151,21135,605,332,937,1655,660,995,10053,51,NA
17085,"Jo Daviess County, Illinois",21942,11058,10884,39477,16549,3010,1236,229,135,21776,516,514,1030,1689,701,988,10721,95,NA
17087,"Johnson County, Illinois",13313,7779,5534,27096,9522,1116,308,102,59,11427,492,312,804,1865,954,911,4316,51,NA
17089,"Kane County, Illinois",517254,259491,257763,44523,341945,79861,34825,5429,4159,513770,22606,17958,40564,42558,18565,23993,263420,3686,0
17091,"Kankakee County, Illinois",107421,53263,54158,32941,71934,8806,4620,746,445,105904,3286,2695,5981,14520,6044,8476,49040,1007,NA
17093,"Kendall County, Illinois",132795,66370,66425,40761,84909,19178,9370,940,884,132490,2686,2583,5269,6280,2660,3620,68047,364,NA
17095,"Knox County, Illinois",49751,25294,24457,28840,34854,4754,1759,288,312,47125,1543,1103,2646,7469,3650,3819,20421,146,NA
17097,"Lake County, Illinois",713159,359281,353878,53677,470203,128444,67150,15908,9252,694803,26635,20520,47155,54519,23563,30956,360255,3729,0
17099,"LaSalle County, Illinois",109495,55761,53734,36060,77499,9511,3842,502,412,106696,2500,2039,4539,14495,6600,7895,51386,430,NA
17101,"Lawrence County, Illinois",15302,8608,6694,30393,11072,1011,418,73,61,13481,724,377,1101,1840,804,1036,5958,18,NA
17103,"Lee County, Illinois",34221,18205,16016,33491,25055,3046,1154,411,123,31582,689,495,1184,3931,1798,2133,15132,112,NA
17105,"Livingston County, Illinois",35771,18285,17486,34996,25201,3100,1183,223,197,33910,859,703,1562,3451,1407,2044,16394,237,NA
17107,"Logan County, Illinois",28027,13619,14408,33280,19761,2695,1010,196,86,25430,436,434,870,2842,1345,1497,12076,31,NA
17109,"McDonough County, Illinois",27370,13336,14034,29658,16716,2678,1777,194,563,26957,992,662,1654,4887,2085,2802,12596,98,NA
17111,"McHenry County, Illinois",311133,155933,155200,46322,213347,49733,20531,3183,1891,309648,8926,6252,15178,18641,8465,10176,162822,1160,0
17113,"McLean County, Illinois",171284,83922,87362,40252,105439,32113,11940,2412,2019,170290,4353,3242,7595,23023,10429,12594,84210,406,NA
17115,"Macon County, Illinois",103542,49921,53621,34644,71303,11357,4370,691,606,101583,2803,2093,4896,15510,6521,8989,44302,284,0
17117,"Macoupin County, Illinois",44907,22332,22575,33665,32052,4294,1473,292,129,44449,1203,631,1834,6453,2939,3514,19857,103,NA
17119,"Madison County, Illinois",265512,130136,135376,38828,184674,34114,15250,2406,2443,263180,7975,5526,13501,31245,13586,17659,127321,685,NA
17121,"Marion County, Illinois",37543,18520,19023,30360,25988,2877,1116,219,130,36884,1460,959,2419,6157,2473,3684,16031,75,NA
17123,"Marshall County, Illinois",11740,5906,5834,34369,8535,1065,298,88,37,11475,252,214,466,1390,607,783,5110,55,NA
17125,"Mason County, Illinois",13074,6433,6641,34223,9456,1154,377,58,49,12872,346,284,630,1767,800,967,5716,90,NA
17127,"Massac County, Illinois",14135,6869,7266,28817,10115,1021,355,77,37,13924,623,479,1102,1901,763,1138,5704,42,NA
17129,"Menard County, Illinois",12284,6051,6233,41497,8663,1355,706,120,60,12138,180,120,300,964,520,444,5863,18,NA
17131,"Mercer County, Illinois",15692,7951,7741,34455,11231,1285,631,72,20,15516,366,449,815,1244,465,779,7255,39,NA
17133,"Monroe County, Illinois",34905,17530,17375,47248,24746,5921,2843,372,234,34610,462,262,724,1481,619,862,18632,220,NA
17135,"Montgomery County, Illinois",28352,15006,13346,30918,20588,2389,1156,115,85,26127,650,592,1242,3640,1790,1850,11366,80,NA
17137,"Morgan County, Illinois",32882,16317,16565,34098,23217,3509,1192,356,153,31245,924,437,1361,3938,1807,2131,14173,58,NA
17139,"Moultrie County, Illinois",14531,7171,7360,34849,9759,1365,600,50,9,14246,1077,909,1986,1307,496,811,6511,99,NA
17141,"Ogle County, Illinois",51672,25836,25836,36436,35975,5486,2442,304,187,51182,1297,1186,2483,4234,1924,2310,24422,236,NA
17143,"Peoria County, Illinois",181186,88477,92709,38581,121844,24988,11713,2466,1901,178998,6103,5262,11365,27284,12379,14905,80437,433,0
17145,"Perry County, Illinois",20996,11462,9534,27880,15183,1133,412,71,46,18734,425,313,738,3257,1434,1823,7830,59,NA
17147,"Piatt County, Illinois",16698,8227,8471,41429,11840,2318,996,150,186,16626,383,266,649,1189,531,658,8230,44,NA
17149,"Pike County, Illinois",14776,7404,7372,28895,10348,1357,363,108,41,14416,519,331,850,1925,879,1046,6292,28,NA
17151,"Pope County, Illinois",3799,1966,1833,26251,2901,303,116,10,19,3676,100,47,147,678,357,321,1263,22,NA
17153,"Pulaski County, Illinois",5177,2600,2577,22947,3627,325,111,90,0,5109,223,131,354,1271,517,754,1690,21,NA
17155,"Putnam County, Illinois",5628,2886,2742,37218,4134,620,239,46,66,5622,108,67,175,492,235,257,2598,15,NA
17157,"Randolph County, Illinois",30413,16471,13942,29832,21938,1891,837,160,126,27426,863,475,1338,3428,1722,1706,12228,61,NA
17159,"Richland County, Illinois",15716,7847,7869,30975,10930,1370,619,63,10,15496,611,282,893,2113,880,1233,7529,42,NA
17161,"Rock Island County, Illinois",143819,71318,72501,34233,98788,15122,6497,1252,899,141286,5533,3394,8927,21084,9905,11179,65172,313,NA
17163,"St. Clair County, Illinois",256791,124864,131927,36010,175247,31097,17972,2431,1738,250716,7819,5696,13515,34784,14868,19916,121312,977,NA
17165,"Saline County, Illinois",23662,11604,12058,34340,17219,2439,695,202,145,23252,701,591,1292,4156,1906,2250,9695,46,NA
17167,"Sangamon County, Illinois",196122,94848,101274,41387,136783,28222,13493,3813,1758,194065,4519,2952,7471,24834,10845,13989,91961,805,NA
17169,"Schuyler County, Illinois",6879,3813,3066,31679,5271,592,246,22,32,6797,517,137,654,1318,987,331,2946,33,NA
17171,"Scott County, Illinois",4899,2468,2431,32891,3462,594,128,40,0,4852,118,124,242,531,228,303,2187,6,NA
17173,"Shelby County, Illinois",21042,10434,10608,32085,15077,1986,665,84,21,20859,522,404,926,2138,1163,975,10097,70,NA
17175,"Stark County, Illinois",5395,2720,2675,32618,3848,524,171,25,10,5292,149,152,301,657,290,367,2384,8,NA
17177,"Stephenson County, Illinois",44482,21763,22719,32900,31630,4130,1854,276,153,43686,1648,1015,2663,5829,2776,3053,20106,238,NA
17179,"Tazewell County, Illinois",131276,64995,66281,38573,92232,17268,6556,957,587,128862,3382,2888,6270,11195,5033,6162,60929,392,NA
17181,"Union County, Illinois",17122,8662,8460,30171,12380,1845,590,128,127,16845,569,505,1074,3372,1722,1650,6750,102,NA
17183,"Vermilion County, Illinois",74113,37165,36948,28933,50638,4973,2372,438,126,71731,2316,1278,3594,12407,5663,6744,29995,115,NA
17185,"Wabash County, Illinois",11321,5516,5805,33137,8048,934,458,65,30,11238,384,240,624,1483,560,923,4981,58,NA
17187,"Warren County, Illinois",16760,8311,8449,32304,10936,1545,513,105,142,16583,410,577,987,2346,1108,1238,7485,86,NA
17189,"Washington County, Illinois",13781,7013,6768,38112,9907,1495,684,69,36,13603,267,167,434,1082,466,616,6716,87,NA
17191,"Wayne County, Illinois",16127,8092,8035,29124,11318,1205,434,141,9,16054,1026,836,1862,2237,1079,1158,7059,40,NA
17193,"White County, Illinois",13834,6758,7076,29977,9985,997,420,140,40,13513,462,511,973,2049,928,1121,5884,84,NA
17195,"Whiteside County, Illinois",55569,27939,27630,35366,39020,4612,2524,294,106,54764,1748,1271,3019,6327,2664,3663,26038,98,NA
17197,"Will County, Illinois",696774,348352,348422,44356,463903,105392,49130,7526,5317,690483,21074,17092,38166,45737,19504,26233,352432,3872,0
17199,"Williamson County, Illinois",67120,33757,33363,34810,47967,7790,3895,694,626,65121,2300,1316,3616,8541,3866,4675,29817,145,NA
17201,"Winnebago County, Illinois",284591,139697,144894,33474,193727,29684,12686,3013,1383,281571,10605,7551,18156,45057,21204,23853,127395,819,NA
17203,"Woodford County, Illinois",38414,19241,19173,41400,25834,5778,2649,391,326,37807,1026,719,1745,2788,1330,1458,18421,62,NA
18001,"Adams County, Indiana",35827,17994,17833,26489,21481,2340,792,91,83,35315,3824,3559,7383,4040,1852,2188,15265,60,NA
18003,"Allen County, Indiana",385456,189922,195534,35389,251806,51044,19131,3937,2650,381762,16365,13737,30102,45562,19527,26035,186470,1177,NA
18005,"Bartholomew County, Indiana",82371,41670,40701,38950,56069,11174,6852,1019,472,81355,2890,1813,4703,9357,4479,4878,40397,283,NA
18007,"Benton County, Indiana",8709,4389,4320,30372,5877,872,170,37,19,8638,281,253,534,1217,494,723,3944,31,NA
18009,"Blackford County, Indiana",12074,5892,6182,29751,8474,779,355,53,65,11932,276,568,844,2019,1000,1019,4852,0,NA
18011,"Boone County, Indiana",71235,35557,35678,54866,47456,14669,5537,2131,1153,70584,1788,1401,3189,4050,1775,2275,36583,628,0
18013,"Brown County, Indiana",15513,7767,7746,40792,11918,2015,837,223,203,15372,506,666,1172,1246,495,751,7134,56,NA
18015,"Carroll County, Indiana",20397,10389,10008,33222,14274,1565,664,99,48,20289,978,1250,2228,1468,647,821,9486,33,NA
18017,"Cass County, Indiana",37820,18812,19008,28391,26047,2599,1166,193,55,37056,1520,1242,2762,5117,2533,2584,17896,69,NA
18019,"Clark County, Indiana",121484,59727,61757,34946,84734,14075,5145,801,823,120175,4334,3315,7649,11609,5609,6000,61188,331,0
18021,"Clay County, Indiana",26396,13130,13266,33430,18327,2202,615,184,104,25908,874,359,1233,2806,1257,1549,11606,45,NA
18023,"Clinton County, Indiana",33020,16560,16460,28063,21391,2293,1027,119,53,32448,1623,1027,2650,2877,1241,1636,15322,81,NA
18025,"Crawford County, Indiana",10511,5422,5089,29114,7507,587,292,9,30,10444,502,220,722,2283,1123,1160,4279,39,NA
18027,"Daviess County, Indiana",33337,16621,16716,28886,20803,2232,757,84,76,32832,4215,3547,7762,3150,1458,1692,14983,163,NA
18029,"Dearborn County, Indiana",50709,25306,25403,36005,35409,5821,2387,211,342,50214,1297,1217,2514,4230,1949,2281,25312,124,NA
18031,"Decatur County, Indiana",26432,13231,13201,34430,17908,2753,785,60,65,26007,430,607,1037,2477,781,1696,13135,69,NA
18033,"DeKalb County, Indiana",43312,21585,21727,33164,29344,3936,1369,165,94,42910,1451,1391,2842,4274,1721,2553,21137,246,NA
18035,"Delaware County, Indiana",112156,54338,57818,28874,69984,10495,5449,757,1123,110529,4476,3594,8070,21600,9742,11858,51601,472,NA
18037,"Dubois County, Indiana",43584,21908,21676,35226,29469,5105,1582,198,166,42797,873,1041,1914,4111,2016,2095,22578,99,NA
18039,"Elkhart County, Indiana",206841,102604,104237,30708,131038,17339,6745,1381,789,204562,15047,15384,30431,24427,11136,13291,97136,420,0
18041,"Fayette County, Indiana",23391,11504,11887,27435,16326,1863,552,56,47,23047,874,860,1734,3761,1604,2157,10093,87,NA
18043,"Floyd County, Indiana",80191,39240,40951,38949,55456,10841,4900,906,708,78981,2137,2065,4202,7359,3003,4356,38923,203,NA
18045,"Fountain County, Indiana",16468,8249,8219,30562,11606,1011,494,51,10,16350,761,584,1345,1965,852,1113,7531,68,NA
18047,"Franklin County, Indiana",22850,11368,11482,36246,15813,2090,997,101,83,22760,546,790,1336,1669,672,997,11370,58,NA
18049,"Fulton County, Indiana",20420,10257,10163,32479,13974,1707,633,40,108,20255,1084,1128,2212,2977,1566,1411,8674,102,NA
18051,"Gibson County, Indiana",33006,16739,16267,31602,22417,2907,891,165,64,32448,1000,565,1565,3210,1302,1908,15614,159,NA
18053,"Grant County, Indiana",66560,31961,34599,27725,44085,4783,2796,180,366,65779,2529,2170,4699,11670,5284,6386,28661,314,NA
18055,"Greene County, Indiana",30900,15614,15286,31155,21948,2434,840,192,73,30597,1347,976,2323,4257,1780,2477,13253,229,NA
18057,"Hamilton County, Indiana",349527,172239,177288,56943,230317,87064,36119,10492,6299,347260,7510,7157,14667,14697,5911,8786,184368,1129,0
18059,"Hancock County, Indiana",80170,39956,40214,42666,55513,12440,4612,661,509,79243,2578,1926,4504,3889,1508,2381,41586,350,NA
18061,"Harrison County, Indiana",39684,20025,19659,33773,28044,3825,1478,356,131,39289,1238,998,2236,2976,1154,1822,18035,13,NA
18063,"Hendricks County, Indiana",175639,88267,87372,43651,118031,30424,12530,2317,1032,172366,6133,3722,9855,8968,4246,4722,91969,886,0
18065,"Henry County, Indiana",48913,25877,23036,29421,34936,4026,1675,112,148,45808,1993,990,2983,6271,3162,3109,20169,126,NA
18067,"Howard County, Indiana",83452,40618,42834,33391,57679,7700,3073,439,230,82254,3093,2454,5547,9910,4494,5416,36245,236,NA
18069,"Huntington County, Indiana",36699,18383,18316,32046,25375,3695,1505,279,84,36243,1404,953,2357,3923,1669,2254,17611,89,NA
18071,"Jackson County, Indiana",46212,23240,22972,31743,31506,3867,1680,239,62,45515,2270,1642,3912,5607,2406,3201,22017,126,NA
18073,"Jasper County, Indiana",33045,16600,16445,35793,22772,2873,1086,198,172,32737,908,738,1646,2427,817,1610,14923,120,NA
18075,"Jay County, Indiana",20451,10298,10153,27794,13590,1022,570,127,40,20247,1039,983,2022,2725,999,1726,8776,87,NA
18077,"Jefferson County, Indiana",33057,15864,17193,30450,23144,2572,1221,119,249,31979,1385,1087,2472,3979,1498,2481,14833,162,NA
18079,"Jennings County, Indiana",27610,14060,13550,30254,19022,1848,646,145,51,27334,1618,1079,2697,3745,1777,1968,12758,16,NA
18081,"Johnson County, Indiana",161952,80197,81755,40055,108217,22035,9774,1895,1397,159791,5122,4633,9755,11886,5415,6471,81130,608,0
18083,"Knox County, Indiana",36148,18385,17763,33052,24166,2815,1169,218,174,35428,1729,1021,2750,4520,1671,2849,17699,82,NA
18085,"Kosciusko County, Indiana",80442,40282,40160,35297,54022,8312,3975,404,343,79732,4286,4091,8377,7023,2930,4093,39179,190,NA
18087,"LaGrange County, Indiana",40364,20433,19931,31404,23540,1652,702,126,163,40206,9607,8535,18142,2261,913,1348,17471,469,NA
18089,"Lake County, Indiana",497682,242732,254950,34458,338457,54950,21718,3778,2311,493922,18966,14479,33445,72391,31598,40793,221831,2679,0
18091,"LaPorte County, Indiana",112215,58203,54012,33048,78906,11189,4148,824,476,105449,3718,3010,6728,15485,6714,8771,48913,260,NA
18093,"Lawrence County, Indiana",45113,22278,22835,32149,31977,3565,2070,347,93,44505,1702,1471,3173,4742,1947,2795,21016,120,NA
18095,"Madison County, Indiana",130545,65913,64632,31556,91235,11740,5012,612,366,126304,5859,4038,9897,17600,7807,9793,58438,472,NA
18097,"Marion County, Indiana",971737,471206,500531,34796,638893,136520,53880,14248,7558,962605,50809,40670,91479,146353,64621,81732,474526,2866,0
18099,"Marshall County, Indiana",46208,23370,22838,32218,30949,4012,1755,319,114,45608,3056,2998,6054,4919,2039,2880,21335,298,NA
18101,"Martin County, Indiana",9863,5091,4772,31921,6871,651,284,32,0,9723,363,365,728,1372,654,718,4688,33,NA
18103,"Miami County, Indiana",35952,19575,16377,28221,25196,2731,939,135,107,33731,2080,1043,3123,5306,2421,2885,15136,85,NA
18105,"Monroe County, Indiana",140065,69953,70112,34750,82493,19900,13808,2201,3855,138980,4288,3824,8112,25891,12648,13243,68299,410,NA
18107,"Montgomery County, Indiana",38018,19455,18563,32975,25900,3398,1486,108,406,37487,1841,1223,3064,4640,1914,2726,17939,53,NA
18109,"Morgan County, Indiana",71757,35959,35798,37861,50065,6802,2620,349,385,70794,2214,1536,3750,5994,2656,3338,34416,189,NA
18111,"Newton County, Indiana",13829,7123,6706,30168,9886,990,187,75,74,13627,503,321,824,1718,884,834,5738,6,NA
18113,"Noble County, Indiana",47431,23977,23454,31953,31895,3931,1366,211,147,46763,2791,2549,5340,3366,1463,1903,22483,310,NA
18115,"Ohio County, Indiana",5974,2959,3015,35310,4392,489,178,19,2,5918,256,141,397,592,191,401,2741,21,NA
18117,"Orange County, Indiana",19768,9889,9879,30435,13737,1279,487,98,52,19492,893,615,1508,2852,1134,1718,9211,119,NA
18119,"Owen County, Indiana",21361,10898,10463,31541,15452,1649,611,92,12,21166,1175,865,2040,2568,1165,1403,9810,29,NA
18121,"Parke County, Indiana",16327,7861,8466,29961,11469,1027,578,65,58,15225,1105,1172,2277,2366,980,1386,6270,40,NA
18123,"Perry County, Indiana",19186,10419,8767,29144,13667,1541,526,105,37,17750,645,289,934,2143,985,1158,8372,111,NA
18125,"Pike County, Indiana",12227,6092,6135,31321,8607,799,384,23,9,12037,296,149,445,1321,745,576,5430,16,NA
18127,"Porter County, Indiana",173355,86060,87295,40792,120140,22294,9572,2190,1878,171693,4804,4325,9129,15779,6740,9039,81856,588,NA
18129,"Posey County, Indiana",25226,12735,12491,37102,17929,3022,1290,105,151,24980,646,310,956,2490,1135,1355,12131,38,NA
18131,"Pulaski County, Indiana",12498,6255,6243,30068,8696,769,349,52,52,12362,453,500,953,1566,618,948,5849,85,NA
18133,"Putnam County, Indiana",36942,19430,17512,31015,24842,3194,1166,265,202,34569,910,691,1601,2869,1275,1594,15990,105,NA
18135,"Randolph County, Indiana",24586,12318,12268,30253,17048,1598,781,97,103,24231,1111,735,1846,3134,1371,1763,10613,187,NA
18137,"Ripley County, Indiana",28990,14424,14566,34578,19738,2105,1287,187,171,28506,1180,953,2133,2738,1252,1486,14452,98,NA
18139,"Rush County, Indiana",16716,8374,8342,29735,11642,1211,574,33,5,16542,577,675,1252,1923,855,1068,7343,34,NA
18141,"St. Joseph County, Indiana",272388,133435,138953,34266,177621,34030,15300,3721,3712,269860,10760,9197,19957,37546,16743,20803,128488,941,NA
18143,"Scott County, Indiana",24403,12208,12195,26506,16991,1324,498,25,111,24017,839,458,1297,3705,1353,2352,10567,41,NA
18145,"Shelby County, Indiana",44940,22269,22671,33909,31447,4206,1543,201,221,44201,1341,1274,2615,5701,2516,3185,21541,229,NA
18147,"Spencer County, Indiana",19935,10161,9774,34874,14156,1752,895,103,69,19697,367,355,722,1415,439,976,9652,90,NA
18149,"Starke County, Indiana",23308,11724,11584,28788,16188,1397,657,46,23,23291,735,715,1450,3144,1192,1952,9336,195,NA
18151,"Steuben County, Indiana",34507,17722,16785,36648,23736,3772,1578,232,216,34263,1041,956,1997,3063,1495,1568,16098,124,NA
18153,"Sullivan County, Indiana",20791,11140,9651,27792,14972,1413,586,37,36,18754,862,800,1662,2263,963,1300,8694,73,NA
18155,"Switzerland County, Indiana",9896,5046,4850,29202,6753,558,151,18,4,9795,552,727,1279,1624,832,792,4361,42,NA
18157,"Tippecanoe County, Indiana",186955,96158,90797,30608,103685,22967,11285,2014,4244,185300,6647,4733,11380,32688,17003,15685,88935,392,NA
18159,"Tipton County, Indiana",15328,7637,7691,34595,10978,1887,694,72,69,15097,719,571,1290,1821,653,1168,7268,20,NA
18161,"Union County, Indiana",7041,3487,3554,33377,5038,721,259,10,13,6985,359,144,503,418,151,267,3533,35,NA
18163,"Vanderburgh County, Indiana",179900,88005,91895,33614,123502,22056,8570,1655,1135,177361,7812,5587,13399,24763,10388,14375,87736,477,NA
18165,"Vermillion County, Indiana",15488,7852,7636,30071,10900,1378,496,39,33,15276,453,283,736,2263,1100,1163,6710,2,NA
18167,"Vigo County, Indiana",106355,53823,52532,30240,68381,10353,5056,722,1379,102779,4882,3215,8097,19702,9283,10419,47887,447,NA
18169,"Wabash County, Indiana",31032,15174,15858,32763,21621,2930,1548,55,156,30030,1225,848,2073,3194,1295,1899,14096,154,NA
18171,"Warren County, Indiana",8454,4216,4238,38792,6046,822,267,42,30,8360,156,279,435,1045,403,642,3978,12,NA
18173,"Warrick County, Indiana",64065,31526,32539,46734,44259,9148,4487,1263,366,63237,1173,985,2158,3815,1813,2002,31207,345,NA
18175,"Washington County, Indiana",28133,13988,14145,28963,19598,2036,556,121,57,27835,1489,950,2439,3626,1683,1943,12768,80,NA
18177,"Wayne County, Indiana",66522,32540,33982,29848,45558,5351,2329,543,441,65187,3826,2901,6727,10246,4538,5708,29789,399,NA
18179,"Wells County, Indiana",28167,13959,14208,33020,18997,2590,772,167,102,27585,862,847,1709,1748,684,1064,14158,43,NA
18181,"White County, Indiana",24630,12424,12206,32001,16992,2131,770,83,123,24405,1289,701,1990,2109,892,1217,11067,73,NA
18183,"Whitley County, Indiana",34259,17275,16984,36515,23775,3974,1075,293,70,33934,1296,1426,2722,3090,1568,1522,16934,147,NA
19001,"Adair County, Iowa",7479,3816,3663,36118,5285,755,152,34,64,7315,240,115,355,736,300,436,3573,17,NA
19003,"Adams County, Iowa",3680,1850,1830,39402,2644,442,68,45,12,3624,119,59,178,341,162,179,1730,2,NA
19005,"Allamakee County, Iowa",14046,7088,6958,33214,9729,1319,369,60,47,13793,494,394,888,1594,609,985,6758,109,NA
19007,"Appanoose County, Iowa",12279,6147,6132,28109,8720,1223,291,67,57,12158,630,347,977,2104,1064,1040,4916,68,NA
19009,"Audubon County, Iowa",5651,2811,2840,33125,4054,648,185,19,27,5525,168,60,228,652,302,350,2806,23,NA
19011,"Benton County, Iowa",25652,12934,12718,37926,17867,2879,1064,149,75,25384,388,299,687,2089,772,1317,13111,75,NA
19013,"Black Hawk County, Iowa",131041,64632,66409,35400,82951,16143,5828,1617,1275,129684,3318,2070,5388,19808,8295,11513,65260,388,NA
19015,"Boone County, Iowa",26700,13632,13068,38479,19033,3658,989,191,184,26266,706,486,1192,1956,1038,918,14054,128,NA
19017,"Bremer County, Iowa",25012,12529,12483,40912,16513,3826,1206,321,263,24679,281,246,527,1541,645,896,12544,16,NA
19019,"Buchanan County, Iowa",20631,10340,10291,34579,13831,2062,742,54,62,20453,768,544,1312,1764,727,1037,10291,28,NA
19021,"Buena Vista County, Iowa",20687,10599,10088,31985,13055,1889,551,253,131,20388,739,482,1221,1391,683,708,10171,27,NA
19023,"Butler County, Iowa",14376,7132,7244,33943,10159,1542,331,73,21,14142,374,170,544,1669,800,869,6733,28,NA
19025,"Calhoun County, Iowa",9893,5162,4731,34490,7078,1074,354,82,5,9217,178,161,339,832,376,456,4196,49,NA
19027,"Carroll County, Iowa",20728,10370,10358,36599,14088,2312,526,152,127,20389,322,324,646,1587,674,913,10600,61,NA
19029,"Cass County, Iowa",13116,6493,6623,36219,9380,1426,372,134,24,12877,306,230,536,1973,862,1111,6486,71,NA
19031,"Cedar County, Iowa",18479,9162,9317,36808,13224,2013,590,56,104,18209,253,373,626,1418,656,762,9612,86,NA
19033,"Cerro Gordo County, Iowa",42979,21433,21546,38377,30790,5056,1609,498,215,42374,1087,649,1736,3929,1687,2242,21675,106,NA
19035,"Cherokee County, Iowa",11601,5842,5759,35939,8270,1186,415,119,76,11308,350,261,611,1506,604,902,5847,12,NA
19037,"Chickasaw County, Iowa",11957,6115,5842,35432,8212,1150,264,69,46,11813,472,404,876,740,346,394,6088,101,NA
19039,"Clarke County, Iowa",9737,5039,4698,32003,6309,611,279,65,7,9566,345,265,610,1611,729,882,4416,19,NA
19041,"Clay County, Iowa",16423,8029,8394,35787,11256,2059,558,261,51,16194,464,286,750,1845,765,1080,8259,17,NA
19043,"Clayton County, Iowa",17123,8663,8460,34394,12308,1573,408,73,59,16925,697,506,1203,2194,1058,1136,8523,263,NA
19045,"Clinton County, Iowa",46488,22930,23558,33979,32458,4879,1432,366,337,45921,1378,891,2269,5649,2369,3280,21251,181,NA
19047,"Crawford County, Iowa",16450,8167,8283,30781,10648,1340,272,95,9,16260,663,790,1453,2759,1068,1691,7703,45,NA
19049,"Dallas County, Iowa",100367,49977,50390,51347,65734,22847,8178,1900,948,99832,2733,1652,4385,5657,2592,3065,54746,649,NA
19051,"Davis County, Iowa",9093,4636,4457,32889,5698,782,250,9,39,8978,1388,1206,2594,843,361,482,4002,265,NA
19053,"Decatur County, Iowa",7684,3912,3772,26334,4761,685,307,90,102,7569,304,277,581,1011,484,527,3437,9,NA
19055,"Delaware County, Iowa",17523,8944,8579,40709,12042,1638,437,107,49,17344,417,318,735,1152,451,701,9504,127,NA
19057,"Des Moines County, Iowa",38824,19118,19706,35689,27152,4164,1459,487,228,38357,789,552,1341,5557,2213,3344,18215,77,NA
19059,"Dickinson County, Iowa",17692,8843,8849,45523,13171,3246,659,300,103,17493,392,373,765,1086,511,575,9231,147,NA
19061,"Dubuque County, Iowa",98812,49036,49776,38705,66284,14121,5422,1032,656,97531,2005,1323,3328,9479,3919,5560,50680,179,NA
19063,"Emmet County, Iowa",9349,4635,4714,34657,6678,735,217,47,16,9102,422,75,497,1096,484,612,4843,106,NA
19065,"Fayette County, Iowa",19519,9870,9649,31566,13601,1684,482,127,42,19160,562,473,1035,2232,1078,1154,9082,78,NA
19067,"Floyd County, Iowa",15601,7993,7608,34900,10875,1421,408,128,23,15393,295,421,716,1673,825,848,7256,26,NA
19069,"Franklin County, Iowa",10015,5078,4937,30733,6948,1053,174,52,9,9868,409,619,1028,1353,664,689,4670,6,NA
19071,"Fremont County, Iowa",6639,3327,3312,37236,4738,765,96,34,13,6503,125,125,250,489,186,303,3089,8,NA
19073,"Greene County, Iowa",8801,4373,4428,32340,6218,893,270,49,13,8691,168,112,280,999,454,545,4337,8,NA
19075,"Grundy County, Iowa",12351,6151,6200,38265,8580,1678,469,46,50,12202,242,121,363,724,239,485,6159,26,NA
19077,"Guthrie County, Iowa",10619,5325,5294,39571,7603,1168,337,75,66,10509,235,103,338,1061,499,562,5221,63,NA
19079,"Hamilton County, Iowa",14979,7637,7342,35822,10592,1871,376,93,45,14745,359,257,616,1144,528,616,7201,17,NA
19081,"Hancock County, Iowa",10790,5493,5297,35033,7683,1262,195,67,27,10585,219,193,412,1046,481,565,5556,87,NA
19083,"Hardin County, Iowa",16861,8496,8365,32181,12328,1845,601,76,44,16393,426,289,715,1355,593,762,8199,147,NA
19085,"Harrison County, Iowa",14623,7452,7171,36998,10166,1529,426,106,33,14359,427,256,683,1092,454,638,7301,44,NA
19087,"Henry County, Iowa",20436,10749,9687,30151,13931,2215,749,98,115,19280,345,303,648,2125,1034,1091,9653,28,NA
19089,"Howard County, Iowa",9479,4787,4692,32033,6381,983,194,36,12,9293,553,356,909,805,378,427,4560,65,NA
19091,"Humboldt County, Iowa",9606,4857,4749,35837,6652,963,221,26,11,9503,313,170,483,1267,590,677,4706,41,NA
19093,"Ida County, Iowa",6969,3506,3463,35708,4740,726,155,29,24,6819,213,126,339,785,357,428,3435,18,NA
19095,"Iowa County, Iowa",16575,8470,8105,40182,11550,1876,533,122,98,16307,278,191,469,1490,737,753,8302,76,NA
19097,"Jackson County, Iowa",19470,9867,9603,34739,13787,1826,581,111,19,19256,550,378,928,1967,1009,958,9135,24,NA
19099,"Jasper County, Iowa",37808,19739,18069,35346,26686,3679,1070,253,247,36155,727,500,1227,3183,1622,1561,18050,173,NA
19101,"Jefferson County, Iowa",15785,8293,7492,36111,12023,2716,1557,298,177,15606,708,358,1066,2074,1033,1041,7486,41,NA
19103,"Johnson County, Iowa",153360,76466,76894,42175,90653,26707,12688,4484,5189,151547,4528,3316,7844,24647,11351,13296,82604,664,0
19105,"Jones County, Iowa",20733,10828,9905,33996,14978,2322,813,74,156,19626,396,173,569,2218,998,1220,9730,63,NA
19107,"Keokuk County, Iowa",10026,5147,4879,32747,6987,816,258,34,35,9910,166,115,281,1207,596,611,4501,26,NA
19109,"Kossuth County, Iowa",14718,7433,7285,34723,10439,1513,401,98,66,14463,385,232,617,1514,632,882,6915,60,NA
19111,"Lee County, Iowa",33442,16597,16845,32465,23857,3476,1032,215,130,32275,713,653,1366,4092,1575,2517,14867,71,NA
19113,"Linn County, Iowa",229308,113646,115662,41446,155869,36999,12544,3056,1319,227377,5286,3457,8743,21239,9410,11829,119071,780,0
19115,"Louisa County, Iowa",10823,5572,5251,33296,7582,864,159,47,24,10676,290,257,547,1072,488,584,5341,87,NA
19117,"Lucas County, Iowa",8666,4457,4209,32575,6066,651,192,43,17,8576,332,391,723,1422,731,691,4024,64,NA
19119,"Lyon County, Iowa",12023,6161,5862,33428,7724,1174,184,84,59,11837,282,290,572,459,203,256,5790,10,NA
19121,"Madison County, Iowa",16609,8470,8139,39442,11322,2186,579,95,62,16428,310,261,571,1007,368,639,8899,31,NA
19123,"Mahaska County, Iowa",22059,11202,10857,33812,14716,2462,640,127,65,21767,482,492,974,2552,1117,1435,11000,32,NA
19125,"Marion County, Iowa",33487,16755,16732,38168,22248,4750,1650,369,289,33169,573,553,1126,2438,992,1446,16435,172,NA
19127,"Marshall County, Iowa",40049,20302,19747,31486,26441,3938,1280,211,126,38697,1183,877,2060,4294,1844,2450,19134,78,NA
19129,"Mills County, Iowa",14605,7156,7449,40709,10081,2116,681,185,95,14257,249,192,441,996,511,485,6839,13,NA
19131,"Mitchell County, Iowa",10537,5286,5251,36006,7240,1140,322,27,63,10333,356,397,753,688,357,331,5611,198,NA
19133,"Monona County, Iowa",8671,4201,4470,33080,6202,696,204,41,32,8484,206,142,348,1040,483,557,4057,31,NA
19135,"Monroe County, Iowa",7574,3774,3800,35392,5203,962,170,27,20,7435,162,115,277,805,361,444,3579,13,NA
19137,"Montgomery County, Iowa",10285,4977,5308,36122,7219,975,276,63,29,10098,134,105,239,1461,487,974,4722,17,NA
19139,"Muscatine County, Iowa",42968,21552,21416,34055,28939,4732,1441,249,297,42201,838,785,1623,4937,2211,2726,20877,71,NA
19141,"O'Brien County, Iowa",14138,7007,7131,32460,9734,1658,379,50,13,13880,262,176,438,1683,776,907,6811,50,NA
19143,"Osceola County, Iowa",6149,3195,2954,35657,4374,431,119,43,27,6037,240,115,355,760,299,461,3035,15,NA
19145,"Page County, Iowa",15225,8006,7219,32886,11345,1381,403,137,85,14325,436,321,757,1918,882,1036,6772,59,NA
19147,"Palo Alto County, Iowa",8938,4526,4412,33517,6058,883,227,78,34,8743,250,120,370,913,412,501,4401,38,NA
19149,"Plymouth County, Iowa",25621,13013,12608,40150,17302,3099,772,227,67,25295,781,584,1365,1433,641,792,13441,71,NA
19151,"Pocahontas County, Iowa",7061,3502,3559,33918,4946,644,142,36,22,6923,246,168,414,626,238,388,3283,20,NA
19153,"Polk County, Iowa",493378,245241,248137,41894,328511,87045,28694,7300,4806,487798,13455,9832,23287,50072,23259,26813,257254,1841,0
19155,"Pottawattamie County, Iowa",93543,46861,46682,34701,63639,10266,3477,759,406,92357,2999,1818,4817,10317,4507,5810,45090,460,NA
19157,"Poweshiek County, Iowa",18608,9129,9479,37527,12160,1983,976,233,320,18317,353,289,642,1828,646,1182,8988,107,NA
19159,"Ringgold County, Iowa",4690,2317,2373,34138,3213,508,158,27,33,4464,198,116,314,369,127,242,2269,22,NA
19161,"Sac County, Iowa",9778,4938,4840,38596,6902,1109,286,83,16,9606,324,174,498,831,413,418,4875,50,NA
19163,"Scott County, Iowa",174315,86169,88146,40926,118337,26358,11137,2331,1501,172559,5984,3702,9686,20277,8647,11630,85855,572,NA
19165,"Shelby County, Iowa",11737,5704,6033,38664,8325,1360,350,98,90,11526,291,220,511,1011,384,627,5912,38,NA
19167,"Sioux County, Iowa",35815,18140,17675,34914,21356,4767,1373,346,191,35411,934,823,1757,2039,929,1110,18709,94,NA
19169,"Story County, Iowa",98573,51726,46847,35704,51740,15589,6867,1197,3529,97986,3104,1856,4960,16953,9319,7634,51376,202,0
19171,"Tama County, Iowa",17017,8627,8390,33046,11597,1490,463,107,65,16654,752,463,1215,2513,1117,1396,8090,19,NA
19173,"Taylor County, Iowa",5916,2949,2967,33092,4110,483,119,25,8,5809,303,85,388,496,221,275,2856,14,NA
19175,"Union County, Iowa",12107,5899,6208,30966,8235,1424,426,84,49,11974,356,439,795,1401,401,1000,5485,20,NA
19177,"Van Buren County, Iowa",7207,3687,3520,32188,5072,638,245,26,27,7138,585,441,1026,788,344,444,2918,25,NA
19179,"Wapello County, Iowa",35292,17753,17539,30025,24087,2795,1185,345,122,34895,1563,810,2373,6001,3074,2927,16045,165,NA
19181,"Warren County, Iowa",52709,26268,26441,41279,34895,7787,2491,540,401,52070,715,511,1226,3135,1401,1734,26985,141,NA
19183,"Washington County, Iowa",22534,11121,11413,35451,15309,2483,946,148,158,22163,919,555,1474,1655,743,912,11443,140,NA
19185,"Wayne County, Iowa",6484,3238,3246,32524,4345,486,137,26,4,6379,381,347,728,847,452,395,2827,63,NA
19187,"Webster County, Iowa",36986,19367,17619,33836,25086,3861,898,269,169,35158,1276,866,2142,4151,1434,2717,17470,105,NA
19189,"Winnebago County, Iowa",10704,5425,5279,34966,7203,1413,340,77,33,10492,197,162,359,779,293,486,5338,17,NA
19191,"Winneshiek County, Iowa",20050,10072,9978,37561,13436,2629,836,319,317,19817,289,202,491,1601,703,898,10797,60,NA
19193,"Woodbury County, Iowa",105526,52847,52679,33080,67477,10689,4149,796,530,104378,4067,2730,6797,13876,6276,7600,52032,116,NA
19195,"Worth County, Iowa",7417,3814,3603,36585,5340,732,215,73,21,7323,190,240,430,537,254,283,3906,43,NA
19197,"Wright County, Iowa",12897,6553,6344,33964,8838,1474,287,71,25,12728,294,284,578,1810,949,861,5740,80,NA
20001,"Allen County, Kansas",12554,6206,6348,27155,8542,1053,562,27,33,12383,676,458,1134,1841,758,1083,5637,6,NA
20003,"Anderson County, Kansas",7799,3886,3913,29665,5228,472,277,36,13,7675,579,475,1054,1004,533,471,3378,100,NA
20005,"Atchison County, Kansas",16309,7909,8400,27644,10037,1331,717,79,98,16168,763,567,1330,2149,772,1377,7614,35,NA
20007,"Barber County, Kansas",4081,2093,1988,32879,2848,511,102,37,23,4038,237,169,406,809,370,439,1906,3,NA
20009,"Barton County, Kansas",25477,12548,12929,31516,17360,2657,845,207,54,25097,1286,1494,2780,3592,1487,2105,12256,26,NA
20011,"Bourbon County, Kansas",14405,7015,7390,29328,9399,1464,607,96,62,14210,812,453,1265,1785,775,1010,6404,23,NA
20013,"Brown County, Kansas",9486,4715,4771,29646,6436,964,285,30,13,9373,552,406,958,1347,553,794,4464,67,NA
20015,"Butler County, Kansas",67618,34400,33218,35209,44550,9268,4046,539,405,64584,2271,2118,4389,5088,2543,2545,31549,213,NA
20017,"Chase County, Kansas",2570,1322,1248,32022,1817,374,89,15,3,2467,94,159,253,216,102,114,1146,27,NA
20019,"Chautauqua County, Kansas",3389,1763,1626,28267,2411,278,88,15,10,3339,240,208,448,587,244,343,1318,24,NA
20021,"Cherokee County, Kansas",19380,9485,9895,26832,13410,1750,756,103,46,19193,964,1008,1972,2615,1157,1458,8682,75,NA
20023,"Cheyenne County, Kansas",2619,1373,1246,34829,1882,327,77,7,7,2577,235,137,372,392,229,163,1261,0,NA
20025,"Clark County, Kansas",1977,1017,960,30253,1355,287,51,10,5,1920,71,51,122,220,87,133,912,14,NA
20027,"Clay County, Kansas",8088,4113,3975,32628,5667,1005,398,48,42,7830,221,211,432,899,435,464,3851,66,NA
20029,"Cloud County, Kansas",9008,4653,4355,28318,5961,860,399,33,45,8775,645,368,1013,1024,510,514,4076,44,NA
20031,"Coffey County, Kansas",8334,4191,4143,35984,5894,907,366,27,8,8207,324,413,737,923,413,510,3832,13,NA
20033,"Comanche County, Kansas",1825,914,911,30989,1305,222,39,3,11,1760,90,64,154,152,78,74,855,4,NA
20035,"Cowley County, Kansas",34661,17550,17111,29977,22925,3620,1644,83,265,33522,1581,1521,3102,4519,1850,2669,15037,253,NA
20037,"Crawford County, Kansas",39012,19945,19067,28530,23276,4567,2132,183,307,38460,2627,1616,4243,7742,3570,4172,19152,136,NA
20039,"Decatur County, Kansas",2771,1407,1364,33767,2103,444,39,36,3,2721,137,68,205,329,109,220,1303,0,NA
20041,"Dickinson County, Kansas",18492,9403,9089,35615,13007,2186,665,118,90,18159,830,1080,1910,1601,728,873,8752,102,NA
20043,"Doniphan County, Kansas",7501,3884,3617,31314,4920,543,246,94,46,7404,290,268,558,768,292,476,3677,44,NA
20045,"Douglas County, Kansas",119094,59385,59709,37261,69746,20252,10893,2089,3249,118392,5107,3673,8780,18017,8860,9157,65718,523,NA
20047,"Edwards County, Kansas",2849,1404,1445,31368,2069,280,64,15,11,2775,146,127,273,378,139,239,1342,26,NA
20049,"Elk County, Kansas",2453,1245,1208,28159,1784,225,94,3,3,2443,128,103,231,362,153,209,943,16,NA
20051,"Ellis County, Kansas",28921,14463,14458,37217,17428,4187,1659,400,502,28712,957,853,1810,4223,2060,2163,16473,40,NA
20053,"Ellsworth County, Kansas",6374,3578,2796,29968,4765,666,255,51,21,5385,192,93,285,471,187,284,2589,0,NA
20055,"Finney County, Kansas",38187,19697,18490,29805,22570,2784,1026,188,178,37915,2547,2592,5139,4791,1976,2815,18361,59,NA
20057,"Ford County, Kansas",34212,17709,16503,28502,20445,2581,1170,214,79,33789,2432,1781,4213,3959,1685,2274,16893,168,NA
20059,"Franklin County, Kansas",25968,13000,12968,32997,17609,2586,1393,186,50,25774,994,774,1768,2100,795,1305,12700,277,NA
20061,"Geary County, Kansas",36247,19277,16970,27030,19547,2830,1561,153,117,31314,1279,1133,2412,6544,2852,3692,17723,234,NA
20063,"Gove County, Kansas",2758,1402,1356,33295,1883,287,54,22,8,2713,184,114,298,173,80,93,1279,17,NA
20065,"Graham County, Kansas",2430,1203,1227,30222,1782,323,90,16,5,2400,119,64,183,238,91,147,1132,79,NA
20067,"Grant County, Kansas",7336,4087,3249,36280,4475,585,162,158,0,7213,585,460,1045,387,178,209,3587,18,NA
20069,"Gray County, Kansas",5719,2933,2786,34339,3504,622,134,4,7,5632,316,306,622,228,98,130,2907,10,NA
20071,"Greeley County, Kansas",1279,609,670,36078,840,147,81,7,7,1252,48,72,120,101,33,68,709,12,NA
20073,"Greenwood County, Kansas",6001,3045,2956,34862,4357,455,177,46,17,5925,324,262,586,903,383,520,2818,52,NA
20075,"Hamilton County, Kansas",2520,1287,1233,28145,1514,225,65,1,0,2511,365,204,569,198,52,146,1161,3,NA
20077,"Harper County, Kansas",5457,2698,2759,26970,3652,418,137,56,27,5312,290,177,467,825,399,426,2140,22,NA
20079,"Harvey County, Kansas",33959,16679,17280,33965,22879,4769,1715,272,259,33281,1477,1357,2834,3163,1172,1991,16396,134,NA
20081,"Haskell County, Kansas",3735,1824,1911,32908,2432,237,111,23,13,3683,340,300,640,332,159,173,1779,16,NA
20083,"Hodgeman County, Kansas",1770,849,921,33911,1222,285,72,5,11,1747,109,57,166,152,48,104,842,8,NA
20085,"Jackson County, Kansas",13274,6748,6526,32499,8894,1185,581,85,14,13114,551,538,1089,1036,399,637,6378,246,NA
20087,"Jefferson County, Kansas",18387,9299,9088,38535,12967,1980,1034,92,71,18162,553,468,1021,1096,626,470,9022,25,NA
20089,"Jewell County, Kansas",2929,1521,1408,32759,2203,279,84,44,0,2897,101,65,166,543,245,298,1272,22,NA
20091,"Johnson County, Kansas",610742,302382,308360,56364,415395,142337,67106,16490,9563,606119,17505,15575,33080,31858,12715,19143,329681,2325,0
20093,"Kearny County, Kansas",3964,2041,1923,29465,2361,246,103,16,27,3893,292,243,535,607,202,405,1680,32,NA
20095,"Kingman County, Kansas",7369,3744,3625,33453,5213,922,251,75,20,7232,416,269,685,570,295,275,3486,19,NA
20097,"Kiowa County, Kansas",2445,1150,1295,35199,1666,333,75,11,3,2377,109,167,276,116,25,91,1232,0,NA
20099,"Labette County, Kansas",20096,10233,9863,29585,13649,1983,782,179,134,19780,1106,838,1944,2988,1422,1566,9028,23,NA
20101,"Lane County, Kansas",1528,754,774,35779,1086,109,98,1,8,1523,126,114,240,137,62,75,782,4,NA
20103,"Leavenworth County, Kansas",82050,43746,38304,37482,55538,11556,6761,873,521,74918,2974,2009,4983,7711,3688,4023,36661,296,NA
20105,"Lincoln County, Kansas",2929,1494,1435,31383,2072,286,182,22,1,2872,106,94,200,368,200,168,1406,13,NA
20107,"Linn County, Kansas",9696,5009,4687,34053,6885,1013,415,69,22,9645,545,439,984,1105,514,591,4188,58,NA
20109,"Logan County, Kansas",2752,1427,1325,38363,1909,385,79,45,0,2721,142,102,244,269,142,127,1433,31,NA
20111,"Lyon County, Kansas",32182,15699,16483,29425,19281,2966,1759,212,212,31741,1876,1498,3374,5034,2273,2761,16237,31,NA
20113,"McPherson County, Kansas",30085,14968,15117,34116,20064,4250,1364,268,413,29324,931,1028,1959,3020,1342,1678,15427,58,NA
20115,"Marion County, Kansas",11867,5993,5874,33087,8061,1512,519,81,116,11551,439,325,764,970,444,526,5588,22,NA
20117,"Marshall County, Kansas",10014,5032,4982,36854,6916,937,320,112,70,9817,283,238,521,1036,440,596,4827,35,NA
20119,"Meade County, Kansas",4019,1999,2020,47644,2581,413,185,4,17,3919,140,232,372,276,92,184,2000,19,NA
20121,"Miami County, Kansas",34312,17443,16869,40169,23390,4707,1896,389,154,33637,1250,946,2196,2347,927,1420,16970,89,NA
20123,"Mitchell County, Kansas",5829,2924,2905,35258,3912,749,294,79,5,5695,401,157,558,854,442,412,2661,5,NA
20125,"Montgomery County, Kansas",31448,15848,15600,28270,21229,2811,1266,134,61,30967,2049,1800,3849,5146,2220,2926,13540,101,NA
20127,"Morris County, Kansas",5385,2791,2594,32462,3898,760,241,60,26,5285,254,169,423,582,289,293,2541,28,NA
20129,"Morton County, Kansas",2688,1268,1420,27423,1858,246,47,28,5,2615,152,102,254,345,138,207,1143,0,NA
20131,"Nemaha County, Kansas",10219,5224,4995,36959,6634,1248,441,147,39,9952,264,337,601,863,297,566,5073,23,NA
20133,"Neosho County, Kansas",15826,7835,7991,29850,10511,1518,565,89,51,15637,961,868,1829,2286,1009,1277,6901,14,NA
20135,"Ness County, Kansas",2677,1370,1307,39978,1852,332,39,16,0,2626,104,118,222,276,116,160,1395,12,NA
20137,"Norton County, Kansas",5431,3053,2378,28514,3995,592,194,36,8,4468,265,303,568,420,120,300,2071,26,NA
20139,"Osage County, Kansas",15787,8107,7680,32120,10905,1463,592,70,60,15589,761,575,1336,1726,860,866,7325,71,NA
20141,"Osborne County, Kansas",3493,1757,1736,34669,2515,439,110,22,11,3394,75,124,199,454,168,286,1815,10,NA
20143,"Ottawa County, Kansas",5768,3025,2743,34893,4040,693,236,13,15,5664,176,154,330,589,289,300,2894,12,NA
20145,"Pawnee County, Kansas",6288,3448,2840,32542,4976,626,209,63,15,5422,414,226,640,642,217,425,2774,50,NA
20147,"Phillips County, Kansas",4960,2526,2434,34396,3498,491,175,33,5,4877,171,208,379,799,423,376,2260,13,NA
20149,"Pottawatomie County, Kansas",25482,12835,12647,35715,16320,3957,1558,241,422,25042,519,712,1231,1821,614,1207,12366,110,NA
20151,"Pratt County, Kansas",9175,4607,4568,31949,5856,1039,434,130,31,9001,517,248,765,1005,412,593,4180,9,NA
20153,"Rawlins County, Kansas",2544,1304,1240,33003,1854,249,43,17,15,2509,130,72,202,274,136,138,1294,3,NA
20155,"Reno County, Kansas",61881,31255,30626,31695,42647,5730,2183,590,243,59380,3050,2399,5449,7243,2996,4247,28709,321,NA
20157,"Republic County, Kansas",4686,2319,2367,31626,3296,552,251,46,22,4614,109,135,244,465,224,241,2166,45,NA
20159,"Rice County, Kansas",9441,4857,4584,32074,6121,970,370,62,50,9255,439,264,703,854,438,416,4323,12,NA
20161,"Riley County, Kansas",72105,38502,33603,33147,35871,9309,4706,876,2266,65035,2223,1721,3944,13920,6893,7027,41152,249,NA
20163,"Rooks County, Kansas",4925,2442,2483,33751,3557,592,174,32,9,4722,161,90,251,218,65,153,2412,18,NA
20165,"Rush County, Kansas",2939,1511,1428,37166,2124,316,79,12,8,2866,85,82,167,368,169,199,1424,1,NA
20167,"Russell County, Kansas",6702,3291,3411,30680,4778,738,180,32,14,6596,303,396,699,1143,629,514,3123,53,NA
20169,"Saline County, Kansas",54160,26987,27173,32504,36749,6655,2545,736,434,53486,2871,1948,4819,6293,2708,3585,26767,300,NA
20171,"Scott County, Kansas",5128,2617,2511,29999,3399,431,123,103,20,5024,123,77,200,379,136,243,2642,0,NA
20173,"Sedgwick County, Kansas",522700,260195,262505,35338,340756,68727,30110,5778,3558,515205,29939,26447,56386,70351,33068,37283,250143,2683,NA
20175,"Seward County, Kansas",21942,11564,10378,25391,12756,1056,281,74,29,21768,1932,1216,3148,2918,1420,1498,10455,164,NA
20177,"Shawnee County, Kansas",178625,87074,91551,36011,121415,24726,10009,2245,1567,175130,7688,6741,14429,22395,9625,12770,83882,564,NA
20179,"Sheridan County, Kansas",2450,1260,1190,41462,1675,296,88,11,12,2418,79,52,131,186,73,113,1349,9,NA
20181,"Sherman County, Kansas",5940,3136,2804,37930,3718,751,193,4,22,5872,274,230,504,590,268,322,3030,17,NA
20183,"Smith County, Kansas",3561,1837,1724,33881,2641,452,102,35,21,3508,158,126,284,256,96,160,1693,26,NA
20185,"Stafford County, Kansas",4054,2116,1938,32921,2759,530,160,29,1,3948,205,139,344,436,241,195,1943,6,NA
20187,"Stanton County, Kansas",2060,1077,983,39063,1409,182,63,0,0,2030,228,201,429,268,161,107,978,16,NA
20189,"Stevens County, Kansas",5275,2729,2546,25674,3256,335,58,7,8,5158,390,384,774,816,353,463,2386,17,NA
20191,"Sumner County, Kansas",22517,11374,11143,31072,15248,2401,1054,126,67,22115,1208,855,2063,2553,1134,1419,9872,39,NA
20193,"Thomas County, Kansas",7907,3957,3950,37610,4949,822,286,98,104,7789,474,312,786,489,200,289,4089,6,NA
20195,"Trego County, Kansas",2798,1410,1388,42029,2143,400,92,32,11,2725,167,42,209,198,100,98,1404,0,NA
20197,"Wabaunsee County, Kansas",6922,3527,3395,34243,4790,817,311,48,27,6814,271,283,554,402,221,181,3246,43,NA
20199,"Wallace County, Kansas",1489,774,715,34406,1022,215,30,16,4,1466,31,33,64,228,98,130,701,1,NA
20201,"Washington County, Kansas",5529,2877,2652,32781,3856,587,161,38,83,5420,194,107,301,538,248,290,2588,25,NA
20203,"Wichita County, Kansas",2131,1120,1011,36589,1540,257,66,3,4,2108,96,72,168,315,157,158,923,3,NA
20205,"Wilson County, Kansas",8667,4329,4338,32008,5988,875,257,17,21,8536,294,266,560,1387,582,805,3860,4,NA
20207,"Woodson County, Kansas",3134,1602,1532,28380,2332,357,124,2,9,3117,154,113,267,408,221,187,1271,14,NA
20209,"Wyandotte County, Kansas",167989,84439,83550,27534,106905,13738,5876,1134,620,166625,16107,13009,29116,27937,12586,15351,76861,527,NA
21001,"Adair County, Kentucky",18887,9564,9323,26098,12713,1139,808,219,202,18634,863,543,1406,3490,1503,1987,7592,58,NA
21003,"Allen County, Kentucky",20773,10364,10409,28307,14374,1577,876,120,57,20579,1101,590,1691,3381,1424,1957,8711,32,NA
21005,"Anderson County, Kentucky",23839,12072,11767,33513,16431,2717,1146,147,154,23740,522,305,827,3160,1470,1690,10865,108,NA
21007,"Ballard County, Kentucky",7742,3905,3837,31315,5559,653,272,11,28,7618,133,147,280,1085,518,567,3224,29,NA
21009,"Barren County, Kentucky",44511,21654,22857,27732,30860,3283,1479,429,193,43853,1970,1846,3816,9187,4240,4947,18337,240,NA
21011,"Bath County, Kentucky",12739,6434,6305,27018,8467,682,456,61,17,12664,543,470,1013,2916,1295,1621,4661,8,NA
21013,"Bell County, Kentucky",24248,12167,12081,19262,16982,1219,518,175,69,23667,853,612,1465,6153,3092,3061,6848,5,NA
21015,"Boone County, Kentucky",136150,67954,68196,41281,89976,19562,8703,1807,1096,135276,4273,2918,7191,7725,3242,4483,69275,856,NA
21017,"Bourbon County, Kentucky",20228,9944,10284,30123,13912,1784,1093,265,91,20041,381,292,673,3015,1441,1574,8999,55,NA
21019,"Boyd County, Kentucky",48242,24188,24054,30993,34293,3883,2442,543,281,46607,1509,994,2503,8071,3262,4809,18840,140,NA
21021,"Boyle County, Kentucky",30613,15451,15162,29955,20631,3121,1856,366,178,29136,880,828,1708,4154,1518,2636,12192,56,NA
21023,"Bracken County, Kentucky",8420,4238,4182,29164,5810,647,330,41,3,8391,203,137,340,1410,607,803,3557,46,NA
21025,"Breathitt County, Kentucky",13580,6865,6715,21985,9773,803,672,155,34,13485,379,121,500,3801,2001,1800,4508,36,NA
21027,"Breckinridge County, Kentucky",20528,10403,10125,27733,14165,1161,650,168,52,20215,1026,654,1680,4734,2367,2367,7611,175,NA
21029,"Bullitt County, Kentucky",82482,41383,41099,34362,58451,6606,3083,344,224,82055,1585,870,2455,8667,3317,5350,40309,255,NA
21031,"Butler County, Kentucky",12365,6315,6050,23862,8642,468,408,84,19,12180,730,701,1431,2367,998,1369,4548,34,NA
21033,"Caldwell County, Kentucky",12635,6229,6406,31255,8871,794,521,79,37,12512,949,455,1404,2024,770,1254,5305,24,NA
21035,"Calloway County, Kentucky",37345,18201,19144,27850,23262,4109,2526,333,367,37028,1441,1161,2602,6405,2779,3626,17096,118,NA
21037,"Campbell County, Kentucky",93122,46195,46927,42846,65046,15843,6894,1874,931,91798,2262,1590,3852,10536,4905,5631,47046,348,NA
21039,"Carlisle County, Kentucky",4782,2402,2380,31403,3314,286,141,2,13,4716,236,107,343,949,457,492,1792,26,NA
21041,"Carroll County, Kentucky",10842,5554,5288,27858,7117,214,151,27,18,10553,584,359,943,2140,932,1208,4464,199,NA
21043,"Carter County, Kentucky",26671,13343,13328,24949,18328,1543,757,206,150,26369,1294,1250,2544,6195,2846,3349,8799,49,NA
21045,"Casey County, Kentucky",15942,7713,8229,22970,11052,711,550,49,40,15582,1086,919,2005,4059,1828,2231,5331,33,NA
21047,"Christian County, Kentucky",72766,38239,34527,25973,41333,5406,1947,358,182,64554,3209,2420,5629,11227,4903,6324,30102,293,NA
21049,"Clark County, Kentucky",36897,18043,18854,36028,25898,3290,1431,329,117,36521,781,796,1577,5451,2128,3323,16615,199,NA
21051,"Clay County, Kentucky",20322,10703,9619,19579,14691,1060,700,257,80,19037,596,423,1019,5891,2626,3265,6120,46,NA
21053,"Clinton County, Kentucky",9295,4644,4651,23905,6593,541,248,57,77,9161,335,231,566,1850,785,1065,3710,45,NA
21055,"Crittenden County, Kentucky",8979,4618,4361,28035,6343,472,229,84,6,8742,619,431,1050,1560,760,800,3374,7,NA
21057,"Cumberland County, Kentucky",5974,2925,3049,22668,4338,503,140,80,20,5893,332,274,606,1658,686,972,2193,0,NA
21059,"Daviess County, Kentucky",102916,50574,52342,33599,69235,10844,5178,935,636,101237,3337,1876,5213,13990,6301,7689,46641,248,NA
21061,"Edmonson County, Kentucky",12179,6134,6045,26781,9005,476,429,97,27,12093,491,513,1004,2035,797,1238,4518,5,NA
21063,"Elliott County, Kentucky",7378,4229,3149,17242,5561,387,165,7,6,6073,209,286,495,1492,683,809,1818,5,NA
21065,"Estill County, Kentucky",14138,7158,6980,21880,10104,779,272,51,21,14023,456,229,685,3353,1318,2035,4572,45,NA
21067,"Fayette County, Kentucky",321276,158371,162905,40953,209558,54431,26794,8778,7537,317011,12927,8828,21755,46179,21066,25113,165422,1195,NA
21069,"Fleming County, Kentucky",15111,7576,7535,26230,10206,998,566,26,21,15090,822,471,1293,3167,1614,1553,5874,32,NA
21071,"Floyd County, Kentucky",35780,17535,18245,22179,25186,1906,1152,224,5,35249,808,887,1695,10254,4682,5572,10890,48,NA
21073,"Franklin County, Kentucky",51475,24937,26538,38104,36106,6670,3667,672,386,50603,1893,1591,3484,6596,3063,3533,24289,138,NA
21075,"Fulton County, Kentucky",6480,3359,3121,19960,4570,526,109,0,6,5977,290,59,349,1633,828,805,2160,9,NA
21077,"Gallatin County, Kentucky",8720,4514,4206,27398,5886,574,140,53,0,8659,591,234,825,1445,755,690,3908,2,NA
21079,"Garrard County, Kentucky",17175,8444,8731,30728,12270,1212,798,325,109,17075,739,503,1242,2657,1140,1517,7139,20,NA
21081,"Grant County, Kentucky",25085,12716,12369,29113,16074,1625,749,96,61,24756,492,697,1189,3157,1155,2002,10990,133,NA
21083,"Graves County, Kentucky",36701,18097,18604,28978,24901,2646,1458,355,182,36351,1591,927,2518,7141,2976,4165,15060,200,NA
21085,"Grayson County, Kentucky",26465,13178,13287,25565,18029,1353,629,247,160,26022,1082,556,1638,5462,2239,3223,10404,84,NA
21087,"Green County, Kentucky",11198,5611,5587,24090,8061,554,412,94,32,11068,490,424,914,2356,1143,1213,3961,37,NA
21089,"Greenup County, Kentucky",35853,17610,18243,32070,25594,2338,1477,462,232,35399,1254,757,2011,5323,2391,2932,13549,27,NA
21091,"Hancock County, Kentucky",9058,4613,4445,30579,6164,729,257,68,20,8959,244,223,467,1345,548,797,3917,2,NA
21093,"Hardin County, Kentucky",111005,55411,55594,35226,73850,10567,5733,1071,301,106132,2930,2715,5645,12401,5267,7134,49975,599,NA
21095,"Harlan County, Kentucky",26589,12841,13748,20511,18583,974,750,160,71,26154,663,629,1292,7799,3590,4209,7271,45,NA
21097,"Harrison County, Kentucky",18803,9126,9677,29748,13038,1248,951,110,45,18620,495,334,829,2925,1264,1661,8227,35,NA
21099,"Hart County, Kentucky",19345,9580,9765,23837,13021,821,483,58,5,19076,1075,704,1779,4259,2141,2118,7675,135,NA
21101,"Henderson County, Kentucky",44770,21685,23085,30949,31311,3763,1799,202,141,43818,1242,590,1832,7431,3114,4317,19291,84,NA
21103,"Henry County, Kentucky",15731,7860,7871,28842,10795,1045,401,122,24,15641,755,590,1345,2534,1110,1424,6857,54,NA
21105,"Hickman County, Kentucky",4491,2153,2338,38895,3277,572,118,11,27,4361,138,65,203,726,355,371,1810,62,NA
21107,"Hopkins County, Kentucky",45223,22060,23163,27878,31412,2671,1534,473,180,44240,1209,850,2059,8424,3447,4977,17727,92,NA
21109,"Jackson County, Kentucky",13002,6507,6495,21876,9069,626,257,129,0,12891,351,160,511,2905,1387,1518,4274,9,NA
21111,"Jefferson County, Kentucky",779232,379431,399801,39994,540624,115392,56060,14137,9642,770994,23621,17611,41232,107897,47347,60550,384235,5008,0
21113,"Jessamine County, Kentucky",53381,25920,27461,37703,35658,6191,3109,754,753,52971,2047,1371,3418,6254,2352,3902,24518,47,NA
21115,"Johnson County, Kentucky",22631,11327,11304,22931,15934,1291,781,179,70,22142,645,458,1103,4728,2053,2675,7168,0,NA
21117,"Kenton County, Kentucky",169066,84198,84868,40780,115530,27047,11326,2724,1031,167849,4575,3537,8112,19922,9241,10681,87466,960,NA
21119,"Knott County, Kentucky",14282,7100,7182,20536,9962,746,692,154,32,14180,237,195,432,3798,1806,1992,4104,45,NA
21121,"Knox County, Kentucky",30207,14686,15521,20658,20402,1833,1014,318,245,29777,1359,650,2009,10030,4389,5641,8941,20,NA
21123,"Larue County, Kentucky",14902,7360,7542,28038,10425,618,850,77,43,14652,283,252,535,2760,1134,1626,6371,5,NA
21125,"Laurel County, Kentucky",62442,30964,31478,26829,43093,3840,2418,558,334,61516,3084,1992,5076,12608,5514,7094,25559,105,NA
21127,"Lawrence County, Kentucky",16228,8148,8080,21163,11140,645,416,124,25,16132,478,625,1103,4236,2293,1943,4394,20,NA
21129,"Lee County, Kentucky",7338,4183,3155,18651,5345,275,92,14,11,6648,130,73,203,2082,1064,1018,2232,81,NA
21131,"Leslie County, Kentucky",10468,5249,5219,18739,7227,518,167,111,39,10143,123,45,168,3381,1537,1844,3236,0,NA
21133,"Letcher County, Kentucky",21490,10702,10788,23522,15377,1134,713,156,10,21266,461,345,806,6082,2827,3255,6866,162,NA
21135,"Lewis County, Kentucky",13063,6475,6588,20579,9123,539,282,28,79,12920,362,393,755,3428,1459,1969,3977,22,NA
21137,"Lincoln County, Kentucky",24320,11989,12331,25972,16721,1554,832,165,21,24086,959,562,1521,4150,2056,2094,9532,13,NA
21139,"Livingston County, Kentucky",8980,4444,4536,31024,6552,487,317,48,12,8926,278,149,427,1503,650,853,3797,87,0
21141,"Logan County, Kentucky",27498,13456,14042,27741,18804,1994,1020,149,55,27149,1590,790,2380,4268,1725,2543,11345,188,NA
21143,"Lyon County, Kentucky",8721,4924,3797,30441,6885,504,351,91,54,7267,266,207,473,724,278,446,3086,24,NA
21145,"McCracken County, Kentucky",67573,32855,34718,36401,47460,7917,3945,990,531,66444,2370,1511,3881,10045,4618,5427,29475,216,NA
21147,"McCreary County, Kentucky",16892,9229,7663,17450,11826,445,214,63,82,15469,408,378,786,5147,2584,2563,4724,51,NA
21149,"McLean County, Kentucky",9173,4604,4569,32382,6369,709,356,46,34,9100,184,137,321,721,333,388,3687,64,NA
21151,"Madison County, Kentucky",92955,45489,47466,31290,57882,11548,5645,932,1172,92039,2980,1952,4932,14057,6446,7611,43928,239,NA
21153,"Magoffin County, Kentucky",11647,5888,5759,19582,8194,299,375,120,98,11518,360,101,461,3503,1701,1802,2859,29,NA
21155,"Marion County, Kentucky",19627,9879,9748,25133,13358,838,583,289,5,18604,321,201,522,4180,1677,2503,7362,70,NA
21157,"Marshall County, Kentucky",31706,15768,15938,32853,22997,2981,1697,350,126,31126,1362,848,2210,3744,1624,2120,13664,256,NA
21159,"Martin County, Kentucky",11298,6382,4916,21276,8275,566,292,33,2,9988,98,134,232,2357,1010,1347,2992,0,NA
21161,"Mason County, Kentucky",17068,8367,8701,33842,11868,1423,942,192,124,16794,518,511,1029,3142,1164,1978,7236,39,NA
21163,"Meade County, Kentucky",29964,15083,14881,34781,20806,2143,1306,198,61,29003,439,705,1144,3925,1640,2285,13684,78,NA
21165,"Menifee County, Kentucky",6174,3284,2890,22682,4391,329,91,53,0,6111,182,154,336,1643,856,787,1989,0,NA
21167,"Mercer County, Kentucky",22662,11343,11319,30424,15846,2070,1133,194,35,22459,834,478,1312,2515,1109,1406,9949,36,NA
21169,"Metcalfe County, Kentucky",10313,5128,5185,23380,7180,552,342,119,0,10236,467,332,799,2447,1067,1380,4206,38,NA
21171,"Monroe County, Kentucky",11331,5645,5686,26549,7836,454,641,84,73,11197,374,263,637,2334,1067,1267,4782,53,NA
21173,"Montgomery County, Kentucky",28188,13700,14488,26423,19217,2061,1111,180,139,27826,1207,743,1950,4525,1749,2776,11427,89,NA
21175,"Morgan County, Kentucky",13840,8000,5840,23257,10226,928,682,120,85,12226,573,405,978,2494,1097,1397,4323,32,NA
21177,"Muhlenberg County, Kentucky",30735,15577,15158,31621,21946,1649,904,199,169,29802,819,712,1531,4840,2194,2646,12094,151,NA
21179,"Nelson County, Kentucky",46779,23364,23415,33585,32231,4407,2176,537,142,46427,1614,881,2495,4051,1833,2218,22182,302,NA
21181,"Nicholas County, Kentucky",7613,3823,3790,24714,5180,169,172,6,20,7507,273,209,482,1215,574,641,2897,22,NA
21183,"Ohio County, Kentucky",23782,11966,11816,26712,16360,1318,917,80,39,23465,865,440,1305,3263,1572,1691,9620,0,NA
21185,"Oldham County, Kentucky",67997,35607,32390,50534,45110,11661,6402,1488,908,64268,1002,1006,2008,2561,1158,1403,32388,173,NA
21187,"Owen County, Kentucky",11229,5702,5527,28446,7895,1158,206,83,43,11127,541,388,929,1571,688,883,4839,58,NA
21189,"Owsley County, Kentucky",4054,2009,2045,19405,3019,226,90,19,0,3962,104,73,177,1114,506,608,1091,38,NA
21191,"Pendleton County, Kentucky",14638,7588,7050,28919,10041,1094,460,86,22,14546,611,270,881,2550,1196,1354,6637,39,NA
21193,"Perry County, Kentucky",28136,13893,14243,27913,19595,1139,940,372,140,27564,545,438,983,6521,2802,3719,9916,35,NA
21195,"Pike County, Kentucky",58196,28771,29425,25153,41556,3511,2340,538,197,57447,1778,1336,3114,13607,6302,7305,18901,174,NA
21197,"Powell County, Kentucky",13089,6658,6431,23336,8915,835,417,77,14,12773,426,262,688,2680,1300,1380,4637,22,NA
21199,"Pulaski County, Kentucky",65145,32025,33120,29215,45989,4560,2624,750,247,64299,2281,2047,4328,13636,5768,7868,26510,119,NA
21201,"Robertson County, Kentucky",2207,944,1263,24146,1525,149,34,3,0,2146,57,52,109,450,185,265,816,0,NA
21203,"Rockcastle County, Kentucky",16171,8035,8136,26640,11492,640,544,164,36,15858,437,305,742,3693,1687,2006,5875,50,NA
21205,"Rowan County, Kentucky",24551,11940,12611,28578,14254,1812,1402,278,368,24214,734,532,1266,5366,2260,3106,10525,47,NA
21207,"Russell County, Kentucky",18021,8931,9090,25790,12422,1124,642,154,122,17794,539,564,1103,3803,1568,2235,7306,79,NA
21209,"Scott County, Kentucky",57286,28239,29047,38391,37778,7371,3447,711,517,57023,1473,1102,2575,5173,2155,3018,28795,125,NA
21211,"Shelby County, Kentucky",48105,23719,24386,37918,33524,6244,3122,453,310,46930,2005,1254,3259,3706,1473,2233,23908,128,NA
21213,"Simpson County, Kentucky",19574,9912,9662,27951,13236,1111,750,41,24,19201,1098,662,1760,2694,998,1696,8711,43,NA
21215,"Spencer County, Kentucky",19549,9878,9671,39997,13533,1924,924,98,41,19439,623,286,909,1607,647,960,9528,101,0
21217,"Taylor County, Kentucky",26056,12768,13288,29899,17026,2425,906,450,134,25567,318,598,916,3551,1280,2271,11795,163,NA
21219,"Todd County, Kentucky",12281,6269,6012,30252,7977,756,533,24,0,12109,1384,1250,2634,2548,1113,1435,4967,104,NA
21221,"Trigg County, Kentucky",14154,7031,7123,30172,10082,1196,666,163,40,14063,896,653,1549,2556,1158,1398,5676,86,NA
21223,"Trimble County, Kentucky",8510,4271,4239,28958,6012,560,223,14,25,8461,225,126,351,1147,466,681,3515,12,NA
21225,"Union County, Kentucky",13495,6847,6648,28196,9388,608,289,15,45,13339,570,180,750,2487,1483,1004,5643,87,NA
21227,"Warren County, Kentucky",135307,66809,68498,34201,82837,16718,7123,2071,1368,134138,5204,3870,9074,22132,9657,12475,65956,887,0
21229,"Washington County, Kentucky",12025,6026,5999,30217,8394,921,711,21,8,11895,392,775,1167,1657,805,852,5686,45,NA
21231,"Wayne County, Kentucky",19666,9723,9943,27016,14032,1067,705,120,48,19389,803,522,1325,4898,2184,2714,6769,13,NA
21233,"Webster County, Kentucky",12951,6488,6463,25177,8802,635,275,30,68,12634,429,341,770,2022,1037,985,5288,8,NA
21235,"Whitley County, Kentucky",36648,18114,18534,22310,23180,2180,1796,172,189,36124,1872,1018,2890,8189,3709,4480,12974,23,NA
21237,"Wolfe County, Kentucky",6573,3442,3131,14727,4484,104,145,34,33,6428,14,53,67,2362,1160,1202,1505,0,NA
21239,"Woodford County, Kentucky",26886,12883,14003,38567,18670,4579,2200,442,370,26632,386,341,727,2228,1013,1215,13540,46,NA
22001,"Acadia Parish, Louisiana",57674,28596,29078,25731,38069,3777,889,192,359,56871,2056,1583,3639,13459,5981,7478,22432,223,NA
22003,"Allen Parish, Louisiana",22798,12751,10047,23971,15864,1285,480,136,10,19242,704,767,1471,3711,1555,2156,7720,116,NA
22005,"Ascension Parish, Louisiana",126973,62764,64209,41355,83300,16316,6193,1084,592,126080,4116,3923,8039,12453,5238,7215,61876,151,NA
22007,"Assumption Parish, Louisiana",21067,10039,11028,28758,14783,1217,576,145,49,20885,1132,695,1827,3354,1344,2010,8361,181,NA
22009,"Avoyelles Parish, Louisiana",39529,19774,19755,23597,26893,2002,885,240,175,36368,1338,1539,2877,10160,4195,5965,14535,391,NA
22011,"Beauregard Parish, Louisiana",36553,18747,17806,33582,24280,2961,1229,83,69,35651,1448,1362,2810,4765,2032,2733,14499,132,NA
22013,"Bienville Parish, Louisiana",12958,6192,6766,22269,9118,823,274,26,6,12632,719,424,1143,3928,1764,2164,4426,27,NA
22015,"Bossier Parish, Louisiana",128877,64006,64871,33873,86122,15201,6740,1207,598,123153,7216,4411,11627,21074,9711,11363,57584,653,NA
22017,"Caddo Parish, Louisiana",236259,112058,124201,31612,160866,22890,11440,3149,1591,231728,10035,7287,17322,50825,21820,29005,95321,1769,NA
22019,"Calcasieu Parish, Louisiana",210770,103638,107132,33486,139900,21647,8064,1859,1383,208892,9362,6797,16159,35580,15901,19679,90879,762,NA
22021,"Caldwell Parish, Louisiana",9658,5100,4558,28491,6877,640,147,17,25,9360,399,238,637,2327,1063,1264,3085,147,NA
22023,"Cameron Parish, Louisiana",5447,2989,2458,33858,3945,384,128,47,9,5424,279,164,443,669,386,283,2531,5,NA
22025,"Catahoula Parish, Louisiana",8895,4655,4240,24910,6294,693,312,7,93,7632,305,327,632,1873,744,1129,2877,44,NA
22027,"Claiborne Parish, Louisiana",14203,7656,6547,18721,10359,786,291,64,66,12273,638,221,859,4005,1676,2329,4112,57,NA
22029,"Concordia Parish, Louisiana",18677,9298,9379,21941,12394,1390,681,105,1,17354,1008,723,1731,5864,2373,3491,5287,172,NA
22031,"De Soto Parish, Louisiana",26821,13130,13691,28772,18435,2027,794,103,85,26610,1278,609,1887,5381,2376,3005,10193,240,NA
22033,"East Baton Rouge Parish, Louisiana",454369,217767,236602,37540,284666,64684,30025,7675,6307,451102,21977,15720,37697,78833,34135,44698,213013,1322,NA
22035,"East Carroll Parish, Louisiana",7371,4122,3249,19646,4833,481,85,0,4,5501,139,104,243,2216,835,1381,1623,49,NA
22037,"East Feliciana Parish, Louisiana",19452,10737,8715,32720,14659,1750,411,171,32,16630,772,565,1337,2441,1090,1351,6530,13,NA
22039,"Evangeline Parish, Louisiana",32335,16410,15925,21877,20961,1961,471,97,34,30906,1753,1069,2822,8576,3606,4970,11046,375,NA
22041,"Franklin Parish, Louisiana",19752,9408,10344,23658,13110,1302,496,107,107,18783,768,549,1317,4884,2176,2708,6500,239,NA
22043,"Grant Parish, Louisiana",22185,12556,9629,25077,15725,1440,347,80,24,19150,1363,498,1861,2855,1222,1633,7706,144,NA
22045,"Iberia Parish, Louisiana",69958,34540,35418,28315,45952,4873,1242,262,128,69218,3283,2256,5539,15953,6164,9789,28561,515,NA
22047,"Iberville Parish, Louisiana",30210,15365,14845,28538,21396,2067,909,88,130,27388,1289,972,2261,4597,1950,2647,12009,140,NA
22049,"Jackson Parish, Louisiana",15093,7624,7469,22804,10772,987,289,59,47,14145,536,506,1042,3706,1598,2108,4867,22,NA
22051,"Jefferson Parish, Louisiana",436171,212244,223927,35720,306562,59420,21457,7246,3167,432383,27024,18354,45378,66951,30586,36365,204156,1578,NA
22053,"Jefferson Davis Parish, Louisiana",32277,16068,16209,30081,21465,1963,1126,132,42,31803,1296,824,2120,5074,2181,2893,12900,195,0
22055,"Lafayette Parish, Louisiana",243175,119067,124108,38161,164601,38795,12044,4234,1939,240985,10179,8016,18195,40006,17724,22282,116494,1012,NA
22057,"Lafourche Parish, Louisiana",97220,47908,49312,32716,66341,8279,2836,457,780,96357,3356,2557,5913,15695,6390,9305,41074,1057,NA
22059,"LaSalle Parish, Louisiana",14764,7999,6765,29769,9974,1196,306,117,146,13697,430,216,646,2081,1043,1038,6278,399,NA
22061,"Lincoln Parish, Louisiana",48323,23783,24540,24411,26298,5494,3079,565,480,47619,2067,1234,3301,13210,6310,6900,20920,88,NA
22063,"Livingston Parish, Louisiana",143425,70817,72608,34237,94939,14911,4782,404,541,142316,6426,5116,11542,16496,7148,9348,64898,224,NA
22065,"Madison Parish, Louisiana",10028,4770,5258,18314,6497,672,181,44,14,8531,516,446,962,3223,1206,2017,2902,50,NA
22067,"Morehouse Parish, Louisiana",25438,12407,13031,22534,17377,1478,606,113,39,24668,1375,546,1921,7067,3202,3865,9196,35,NA
22069,"Natchitoches Parish, Louisiana",37478,18089,19389,25302,22411,3018,1534,232,333,36715,1591,1213,2804,9184,4035,5149,14014,169,NA
22071,"Orleans Parish, Louisiana",380408,179688,200720,37013,270382,60578,30525,12502,6537,375045,19766,12172,31938,84133,37008,47125,171424,2755,6
22073,"Ouachita Parish, Louisiana",159585,77016,82569,29670,104662,17102,7196,1847,882,156022,7059,5353,12412,36050,15611,20439,67312,530,NA
22075,"Plaquemines Parish, Louisiana",23305,12112,11193,35413,15539,2016,633,214,90,22271,748,508,1256,3379,1421,1958,10962,92,NA
22077,"Pointe Coupee Parish, Louisiana",20652,10201,10451,31595,14640,1657,378,110,18,20522,1309,479,1788,3922,1640,2282,7836,265,NA
22079,"Rapides Parish, Louisiana",129536,62847,66689,31010,86319,12220,4695,1481,854,126932,6622,4632,11254,23102,10421,12681,54593,1770,NA
22081,"Red River Parish, Louisiana",7631,3839,3792,23162,5092,363,131,2,46,7437,417,286,703,1800,750,1050,2849,22,NA
22083,"Richland Parish, Louisiana",20028,9951,10077,25285,13493,1315,681,167,41,19115,1062,728,1790,4591,2265,2326,7436,89,NA
22085,"Sabine Parish, Louisiana",22209,11048,11161,24911,15114,1484,441,38,49,21880,1113,1009,2122,5237,2254,2983,7234,344,NA
22087,"St. Bernard Parish, Louisiana",44038,21711,22327,28451,29124,3315,1168,265,152,43811,2128,1414,3542,9840,4684,5156,18507,99,NA
22089,"St. Charles Parish, Louisiana",52191,26017,26174,38220,35224,7025,2011,332,200,51620,1667,1473,3140,5249,2725,2524,23995,166,NA
22091,"St. Helena Parish, Louisiana",10872,5400,5472,24660,7441,616,172,16,90,10734,642,339,981,2942,1177,1765,3668,149,NA
22093,"St. James Parish, Louisiana",20090,9716,10374,33616,14008,1779,672,83,81,19916,634,574,1208,2282,941,1341,8729,57,NA
22095,"St. John the Baptist Parish, Louisiana",41986,20563,21423,30643,27757,2863,1410,197,76,41508,1779,1041,2820,5830,2645,3185,17519,224,NA
22097,"St. Landry Parish, Louisiana",82574,40045,42529,24413,53626,4931,1788,596,255,81457,4166,2969,7135,22276,9710,12566,29973,390,NA
22099,"St. Martin Parish, Louisiana",51856,25442,26414,28679,35192,3615,1223,118,41,51557,2168,1920,4088,9019,3807,5212,21696,143,NA
22101,"St. Mary Parish, Louisiana",49114,24037,25077,26949,33751,2823,1229,78,29,48415,1966,1032,2998,10623,4829,5794,19136,127,NA
22103,"St. Tammany Parish, Louisiana",266168,130486,135682,40393,182793,42984,16468,4736,2325,263023,11091,7188,18279,30682,13182,17500,121358,1292,NA
22105,"Tangipahoa Parish, Louisiana",133953,65523,68430,29192,87535,12831,4379,997,606,132910,6385,3554,9939,24896,10569,14327,56297,655,0
22107,"Tensas Parish, Louisiana",4127,1948,2179,21019,2947,262,69,41,47,4016,188,149,337,1403,494,909,1154,16,NA
22109,"Terrebonne Parish, Louisiana",108862,53934,54928,32143,72589,8098,3466,457,353,107574,4435,3372,7807,17532,7794,9738,46254,1306,NA
22111,"Union Parish, Louisiana",21049,10450,10599,28575,14883,2025,307,225,28,20529,988,671,1659,5507,2386,3121,7984,33,NA
22113,"Vermilion Parish, Louisiana",57202,27840,29362,29293,38106,5270,1095,374,402,56519,2238,1979,4217,10909,4413,6496,22422,188,NA
22115,"Vernon Parish, Louisiana",48452,25336,23116,28797,30151,4115,1220,199,114,42666,2131,1306,3437,8390,3529,4861,20966,350,NA
22117,"Washington Parish, Louisiana",45514,22961,22553,24287,31322,2493,982,172,24,43854,2620,1360,3980,10294,4613,5681,16324,835,NA
22119,"Webster Parish, Louisiana",36761,18033,18728,22706,25447,2582,803,173,108,35881,1737,864,2601,9888,4569,5319,12853,176,NA
22121,"West Baton Rouge Parish, Louisiana",27377,13586,13791,33445,19426,3287,965,148,84,26585,1072,663,1735,3922,1448,2474,12469,51,NA
22123,"West Carroll Parish, Louisiana",9800,4829,4971,25949,6839,469,285,26,2,9523,457,357,814,1827,690,1137,3554,4,NA
22125,"West Feliciana Parish, Louisiana",15358,10458,4900,30055,11898,1709,580,159,70,11780,490,116,606,1676,1126,550,5572,7,NA
22127,"Winn Parish, Louisiana",13665,7258,6407,25617,9808,844,396,32,30,12110,831,372,1203,2361,797,1564,4788,168,NA
23001,"Androscoggin County, Maine",111532,54855,56677,34273,77350,11847,4343,919,533,109996,4823,3284,8107,13334,6455,6879,54700,420,NA
23003,"Aroostook County, Maine",67237,33504,33733,31001,50230,7343,2435,522,450,66063,3580,2239,5819,9755,4107,5648,28276,432,NA
23005,"Cumberland County, Maine",303357,148066,155291,51405,222300,67158,30995,9232,5160,299602,8221,6864,15085,21265,9642,11623,164899,1556,NA
23007,"Franklin County, Maine",29839,14662,15177,33161,21486,4035,1402,446,300,29653,1440,1286,2726,3477,1352,2125,13669,286,NA
23009,"Hancock County, Maine",55851,27342,28509,38785,42391,9856,4055,816,786,55295,3284,2340,5624,5949,2678,3271,27161,350,NA
23011,"Kennebec County, Maine",124003,60678,63325,36009,90019,16692,6810,1536,1850,122177,5239,3441,8680,14938,6195,8743,59235,376,NA
23013,"Knox County, Maine",40729,20526,20203,39379,31106,7362,3050,845,517,39235,1635,1286,2921,3892,1437,2455,18931,174,NA
23015,"Lincoln County, Maine",35466,17538,17928,43436,27325,6501,3094,713,411,35029,1650,1479,3129,3182,1420,1762,16466,102,NA
23017,"Oxford County, Maine",58276,29200,29076,30884,44069,6398,2534,354,180,57733,3295,1925,5220,8259,3782,4477,25576,227,NA
23019,"Penobscot County, Maine",152640,75942,76698,34423,110023,20779,8282,1799,1909,150696,6736,5259,11995,19608,8605,11003,72207,928,NA
23021,"Piscataquis County, Maine",16936,8571,8365,32843,13075,1990,512,149,73,16698,1131,619,1750,2479,1175,1304,6957,74,NA
23023,"Sagadahoc County, Maine",36868,18230,18638,40950,27860,6223,3330,604,613,36706,1610,853,2463,3979,1877,2102,18551,179,NA
23025,"Somerset County, Maine",50656,25290,25366,31348,37813,5392,1602,243,230,50013,2326,1653,3979,8331,3772,4559,22146,184,NA
23027,"Waldo County, Maine",39772,19799,19973,35677,29692,5948,2909,552,467,39585,2151,2017,4168,5035,2406,2629,18015,178,NA
23029,"Washington County, Maine",31096,15385,15711,30731,23012,3643,1430,311,283,30559,1923,1298,3221,5276,2426,2850,12356,55,NA
23031,"York County, Maine",212691,104642,108049,42053,158210,33566,14078,3024,1841,210535,6325,4946,11271,16732,7752,8980,111025,621,NA
24001,"Allegany County, Maryland",68161,35912,32249,29343,47914,5726,3162,627,464,63226,1600,913,2513,9692,4281,5411,26115,139,NA
24003,"Anne Arundel County, Maryland",588109,291860,296249,56187,409052,102712,59718,10161,7921,569274,14364,11391,25755,33687,13740,19947,306689,2580,0
24005,"Baltimore County, Maryland",850737,405306,445431,46603,589611,136268,75168,19674,11589,843374,24346,20607,44953,84846,35773,49073,422546,4737,0
24009,"Calvert County, Maryland",93244,46543,46701,54038,64176,12420,8196,1214,1001,91646,1636,1270,2906,3959,1679,2280,48004,385,NA
24011,"Caroline County, Maryland",33320,16414,16906,34655,22837,2362,1335,259,88,32946,1367,878,2245,4228,1670,2558,15769,441,NA
24013,"Carroll County, Maryland",173225,86406,86819,49434,120559,28729,14404,1839,1750,170993,2816,2135,4951,8646,3807,4839,90034,337,0
24015,"Cecil County, Maryland",103876,51773,52103,40520,72203,11804,5943,837,732,102703,2184,1844,4028,10341,4750,5591,49384,413,NA
24017,"Charles County, Maryland",167035,80711,86324,47977,112613,20490,12028,1211,1248,164151,3630,3007,6637,9729,4971,4758,84812,671,NA
24019,"Dorchester County, Maryland",32557,15261,17296,33950,23327,2425,1381,379,283,32203,1097,593,1690,4951,2055,2896,14681,27,NA
24021,"Frederick County, Maryland",273829,135810,138019,51169,186771,45788,26944,4018,4729,271096,6885,5365,12250,16599,6754,9845,143078,1061,0
24023,"Garrett County, Maryland",28856,14499,14357,41130,21440,2893,1743,337,306,28447,965,693,1658,3123,1384,1739,13283,71,NA
24025,"Harford County, Maryland",261059,128609,132450,48615,182063,40140,23919,3701,2830,258939,4717,4245,8962,18524,7764,10760,134818,1068,NA
24027,"Howard County, Maryland",332011,164011,168000,63441,225256,69388,51058,11430,12314,327940,7230,5478,12708,17671,7556,10115,173546,1513,0
24029,"Kent County, Maryland",19289,9215,10074,44283,13958,2939,1474,404,397,18878,294,514,808,1693,842,851,9119,186,NA
24031,"Montgomery County, Maryland",1056910,515682,541228,64126,729862,198924,143937,48238,47025,1047716,39289,31001,70290,75205,32875,42330,551214,6800,6
24033,"Prince George's County, Maryland",957189,463483,493706,43833,656203,131451,78059,12167,12155,948956,56769,42614,99383,89651,38327,51324,492653,7956,NA
24035,"Queen Anne's County, Maryland",50316,25045,25271,52652,36066,8244,3623,774,549,49925,1449,1072,2521,3419,1377,2042,25693,80,0
24037,"St. Mary's County, Maryland",113814,57408,56406,49755,76139,15055,9665,905,961,110856,2536,1858,4394,8456,3886,4570,58080,567,NA
24039,"Somerset County, Maryland",24672,13521,11151,24176,16964,1965,657,99,137,21317,559,281,840,3922,1942,1980,9396,68,NA
24041,"Talbot County, Maryland",37663,18023,19640,52555,28623,6565,3227,1424,649,37264,918,706,1624,3460,1453,2007,16883,192,NA
24043,"Washington County, Maryland",154645,78755,75890,36528,108258,14675,8023,1323,853,147494,4319,3726,8045,18137,8013,10124,70057,500,0
24045,"Wicomico County, Maryland",103815,49720,54095,35658,65721,11476,5367,1272,910,102678,3927,2699,6626,13844,5745,8099,50503,309,NA
24047,"Worcester County, Maryland",52827,25841,26986,48769,40258,8043,3873,517,485,52121,1764,1245,3009,4275,1804,2471,24119,105,NA
24510,"Baltimore city, Maryland",584548,273088,311460,37845,410221,72434,47683,13069,9988,576826,18570,13119,31689,110509,48745,61764,270605,4233,0
25001,"Barnstable County, Massachusetts",229436,110706,118730,55940,180261,45373,27082,5832,4734,227064,4033,2857,6890,15911,6652,9259,111344,1151,0
25003,"Berkshire County, Massachusetts",128763,63103,65660,45300,95692,19592,11718,2727,2283,126877,1679,1033,2712,13518,6611,6907,62128,324,0
25005,"Bristol County, Massachusetts",576699,281769,294930,42006,407256,78287,32584,5564,4455,571357,10117,6552,16669,62801,27832,34969,285132,1949,NA
25007,"Dukes County, Massachusetts",20543,10091,10452,60845,15726,3694,1995,831,268,20446,712,611,1323,1364,619,745,10084,5,0
25009,"Essex County, Massachusetts",806103,392144,413959,50932,562867,138834,72217,13259,10651,799708,13977,9523,23500,76850,32714,44136,412030,6512,8
25011,"Franklin County, Massachusetts",70980,35030,35950,40282,54094,11539,6909,1475,1607,70351,994,547,1541,8360,3589,4771,35365,196,NA
25013,"Hampden County, Massachusetts",464575,226201,238374,35884,318443,54812,27822,5326,3266,459639,8951,5287,14238,71252,31319,39933,209900,2325,NA
25015,"Hampshire County, Massachusetts",153931,72786,81145,43639,99735,24676,17416,2872,5304,152766,1696,1388,3084,14133,6701,7432,75077,377,NA
25017,"Middlesex County, Massachusetts",1623109,802270,820839,64197,1145170,330386,227598,45493,66073,1609381,24125,16404,40529,117050,53176,63874,881099,10071,20
25019,"Nantucket County, Massachusetts",14065,7722,6343,62153,9942,3481,1411,347,465,14030,521,137,658,687,313,374,7418,49,NA
25021,"Norfolk County, Massachusetts",722112,350867,371245,66685,509433,148960,93667,23785,20370,715124,8308,5489,13797,45607,19822,25785,379344,3479,0
25023,"Plymouth County, Massachusetts",529548,259441,270107,53423,372525,93963,43905,8433,4731,523001,7474,5119,12593,34547,14388,20159,268672,2693,0
25025,"Suffolk County, Massachusetts",785443,380529,404914,53173,551133,146861,80599,25609,18299,780275,16880,10287,27167,126977,57163,69814,424949,5559,14
25027,"Worcester County, Massachusetts",858898,426680,432218,45433,597824,133862,72394,11492,11623,848681,12855,8351,21206,83304,38656,44648,432718,6034,7
26001,"Alcona County, Michigan",10238,5199,5039,31167,8440,1041,540,70,35,10151,254,180,434,1604,700,904,3446,37,NA
26003,"Alger County, Michigan",8866,4943,3923,25099,6562,965,323,34,37,7839,165,113,278,801,380,421,2856,63,NA
26005,"Allegan County, Michigan",120189,60422,59767,35220,82354,13239,5265,797,574,119248,3819,2291,6110,11307,5257,6050,56188,608,NA
26007,"Alpena County, Michigan",28911,14366,14545,30893,21535,2221,1051,288,43,28541,903,660,1563,4685,2138,2547,11893,244,NA
26009,"Antrim County, Michigan",23662,11833,11829,39166,18006,3587,1751,359,146,23499,787,539,1326,2199,902,1297,10480,221,NA
26011,"Arenac County, Michigan",15031,7684,7347,29246,11313,1088,475,50,36,14906,429,418,847,2019,909,1110,6023,94,NA
26013,"Baraga County, Michigan",8245,4572,3673,28665,6254,645,214,86,28,7219,182,154,336,877,402,475,2935,24,NA
26015,"Barry County, Michigan",62581,31577,31004,38843,44172,7242,2430,406,360,62233,1926,1108,3034,5163,2163,3000,28461,276,NA
26017,"Bay County, Michigan",103752,51394,52358,33331,75152,10450,3416,763,466,102944,3265,2048,5313,15715,6879,8836,47237,260,NA
26019,"Benzie County, Michigan",18058,9065,8993,38875,13789,2713,1381,245,134,17866,732,463,1195,1862,951,911,7895,103,NA
26021,"Berrien County, Michigan",153938,75863,78075,36764,108050,19850,9427,1686,1534,152824,5833,3833,9666,23756,10464,13292,69571,571,NA
26023,"Branch County, Michigan",44795,23151,21644,29824,30962,3486,1170,166,151,42842,2413,2184,4597,6409,2871,3538,18889,232,NA
26025,"Calhoun County, Michigan",134011,66230,67781,32047,91454,13238,5286,958,679,132416,4297,3387,7684,19360,9234,10126,58169,484,NA
26027,"Cass County, Michigan",51604,25911,25693,36851,36887,5032,2195,348,233,51467,1609,1339,2948,6573,3048,3525,23505,260,NA
26029,"Charlevoix County, Michigan",26174,13106,13068,43782,19558,3914,1839,529,170,25924,1088,790,1878,2230,880,1350,12426,144,NA
26031,"Cheboygan County, Michigan",25709,13072,12637,32679,19958,2667,1326,318,181,25450,943,587,1530,3029,1377,1652,10225,54,NA
26033,"Chippewa County, Michigan",36670,19879,16791,31167,25632,3700,1536,300,325,33637,1313,1023,2336,5441,2491,2950,15504,211,NA
26035,"Clare County, Michigan",30998,15586,15412,27147,22771,1650,895,112,113,30680,2069,1534,3603,6765,3057,3708,10714,110,NA
26037,"Clinton County, Michigan",79249,39424,39825,41790,55160,11239,4620,1260,666,78663,1844,1266,3110,7488,3459,4029,38854,209,NA
26039,"Crawford County, Michigan",13197,6782,6415,30379,10082,1192,628,117,36,13032,422,299,721,1798,891,907,5115,29,NA
26041,"Delta County, Michigan",36839,18645,18194,32311,27183,3750,1163,334,108,36432,991,926,1917,4802,2209,2593,14790,125,NA
26043,"Dickinson County, Michigan",25937,13219,12718,35722,19042,3142,1133,167,105,25647,761,491,1252,2477,1078,1399,11750,191,NA
26045,"Eaton County, Michigan",109072,54056,55016,39207,77481,15772,5747,1029,911,108283,2782,1945,4727,8156,3670,4486,52669,347,NA
26047,"Emmet County, Michigan",34072,17083,16989,42373,24986,5539,2916,694,315,33705,1297,791,2088,2816,1237,1579,16802,161,NA
26049,"Genesee County, Michigan",405280,196717,208563,33562,280153,41339,17176,3728,1595,403025,11662,7819,19481,65056,29216,35840,170085,985,NA
26051,"Gladwin County, Michigan",25461,12823,12638,30893,18968,1784,748,145,49,25288,1199,964,2163,3574,1756,1818,9131,187,NA
26053,"Gogebic County, Michigan",14597,7649,6948,33516,11325,1667,566,192,108,14198,457,265,722,1993,978,1015,6038,33,NA
26055,"Grand Traverse County, Michigan",95315,47300,48015,40644,68969,15878,7695,1935,1156,94469,2794,2030,4824,9772,5027,4745,47745,368,NA
26057,"Gratiot County, Michigan",41534,22438,19096,28123,28563,3514,1316,141,207,37099,1072,829,1901,5007,2157,2850,16782,97,NA
26059,"Hillsdale County, Michigan",45698,22937,22761,30409,31504,3631,1927,228,377,45393,1880,1275,3155,6682,3241,3441,19694,197,NA
26061,"Houghton County, Michigan",37414,20576,16838,29173,21681,4125,2395,189,1047,36974,1479,839,2318,5838,3275,2563,16375,233,NA
26063,"Huron County, Michigan",31461,15783,15678,32069,23224,2558,934,262,100,31131,1213,672,1885,3501,1602,1899,13374,96,NA
26065,"Ingham County, Michigan",282540,138535,144005,36077,174119,38966,20143,5508,6146,280876,8422,5602,14024,43825,21498,22327,137987,1174,NA
26067,"Ionia County, Michigan",66663,36307,30356,29736,46270,5605,1823,260,106,63338,2701,1544,4245,6508,2568,3940,29980,156,NA
26069,"Iosco County, Michigan",25319,12647,12672,28301,19618,1882,1047,195,79,25043,988,627,1615,3767,1885,1882,9130,35,NA
26071,"Iron County, Michigan",11585,5871,5714,31990,8930,1147,485,82,59,11307,414,270,684,1642,740,902,4427,90,NA
26073,"Isabella County, Michigan",64938,31554,33384,28809,36064,5938,3410,551,1156,64436,2739,2272,5011,13998,6104,7894,30645,224,NA
26075,"Jackson County, Michigan",160637,82776,77861,33065,112132,16714,6832,924,739,152485,4966,3787,8753,18276,8030,10246,68511,483,NA
26077,"Kalamazoo County, Michigan",261426,128595,132831,37852,164896,40547,19120,3765,3322,259351,7459,5267,12726,33911,14794,19117,129059,708,NA
26079,"Kalkaska County, Michigan",17934,9122,8812,31074,12992,1403,614,154,82,17838,746,554,1300,2615,1183,1432,7438,62,NA
26081,"Kent County, Michigan",657321,326880,330441,39342,438030,108970,44237,9676,6148,652424,18918,13533,32451,69388,29138,40250,336075,2235,0
26083,"Keweenaw County, Michigan",2088,1093,995,41795,1734,379,208,17,60,2084,110,46,156,163,71,92,774,17,NA
26085,"Lake County, Michigan",12285,6753,5532,25695,9642,851,254,38,29,12017,383,458,841,2434,1369,1065,3935,65,NA
26087,"Lapeer County, Michigan",88687,45727,42960,37419,63664,8065,3330,489,281,87087,3217,2357,5574,8832,3979,4853,40090,284,NA
26089,"Leelanau County, Michigan",22426,11155,11271,48491,17562,4935,2549,720,338,22244,578,476,1054,1483,796,687,9470,98,NA
26091,"Lenawee County, Michigan",99263,50546,48717,32976,69488,10011,4635,572,403,96102,3040,2290,5330,10451,4608,5843,42860,204,NA
26093,"Livingston County, Michigan",194302,98266,96036,47253,138319,35752,13777,2137,1088,193286,3880,2511,6391,9362,4057,5305,97209,472,NA
26095,"Luce County, Michigan",5442,2865,2577,23599,4125,411,258,42,2,4410,50,65,115,804,369,435,1417,45,NA
26097,"Mackinac County, Michigan",10843,5594,5249,35512,8510,1360,609,159,61,10708,726,477,1203,1685,894,791,4287,49,NA
26099,"Macomb County, Michigan",878453,431113,447340,38015,623718,107738,46474,8813,4136,871490,24723,19558,44281,85418,36777,48641,422678,2749,NA
26101,"Manistee County, Michigan",25058,12966,12092,33818,19067,3016,829,295,154,23722,536,539,1075,2667,1159,1508,9535,57,NA
26103,"Marquette County, Michigan",66376,33782,32594,32711,44267,10526,3415,736,677,64689,1507,1172,2679,8535,3762,4773,30498,213,NA
26105,"Mason County, Michigan",29178,14609,14569,34386,21299,3067,1651,262,175,28939,1227,680,1907,3944,1752,2192,12200,39,NA
26107,"Mecosta County, Michigan",40128,20158,19970,27692,26586,3940,1705,215,454,39867,1854,1238,3092,6778,3481,3297,16342,191,NA
26109,"Menominee County, Michigan",23433,12105,11328,31313,17526,1952,780,80,107,23144,728,419,1147,2464,1240,1224,10557,91,NA
26111,"Midland County, Michigan",83503,41623,41880,41594,59321,12630,5998,943,1561,82774,1927,1288,3215,8337,3940,4397,37379,234,NA
26113,"Missaukee County, Michigan",15089,7634,7455,29386,10645,1263,426,48,58,14992,828,543,1371,1676,686,990,6424,34,NA
26115,"Monroe County, Michigan",154823,77273,77550,37704,109932,15952,6969,1211,710,153758,3299,2297,5596,16690,7489,9201,69702,646,NA
26117,"Montcalm County, Michigan",66901,35863,31038,28370,47374,4683,1783,232,107,64357,3406,1989,5395,7882,3715,4167,28450,229,NA
26119,"Montmorency County, Michigan",9261,4727,4534,28394,7334,741,279,48,46,9187,374,227,601,1690,793,897,3115,13,NA
26121,"Muskegon County, Michigan",175947,88360,87587,30812,121491,17502,5966,1238,435,171459,4937,3436,8373,21923,10246,11677,75385,380,NA
26123,"Newaygo County, Michigan",50130,25483,24647,29687,35223,4372,1589,296,174,49647,2060,1655,3715,7537,3550,3987,21259,189,NA
26125,"Oakland County, Michigan",1272264,629093,643171,53157,906930,253140,145801,34240,16060,1265417,29271,22191,51462,97107,41762,55345,646051,4736,5
26127,"Oceana County, Michigan",26707,13698,13009,28786,18800,2357,1011,129,187,26522,1438,933,2371,3657,1786,1871,11214,97,NA
26129,"Ogemaw County, Michigan",20820,10528,10292,28837,15698,1535,541,143,68,20538,655,379,1034,3485,1700,1785,7482,55,NA
26131,"Ontonagon County, Michigan",5862,3005,2857,30182,4866,502,191,32,15,5800,120,114,234,794,322,472,1992,22,NA
26133,"Osceola County, Michigan",23022,11774,11248,27211,16242,1796,693,83,114,22706,1207,852,2059,3551,1692,1859,8921,50,NA
26135,"Oscoda County, Michigan",8264,4231,4033,26129,6160,579,244,10,16,8219,656,572,1228,1139,589,550,2719,24,NA
26137,"Otsego County, Michigan",25221,12768,12453,34190,18112,3142,1310,235,69,25057,1108,775,1883,2653,985,1668,11517,21,NA
26139,"Ottawa County, Michigan",296183,147228,148955,39116,186701,45105,17733,2512,2791,294651,5664,4283,9947,21639,8919,12720,150765,653,0
26141,"Presque Isle County, Michigan",13083,6562,6521,34698,10295,1389,487,138,28,12980,383,401,784,1645,716,929,4614,118,NA
26143,"Roscommon County, Michigan",23556,11891,11665,34587,18908,1983,959,487,71,23364,777,485,1262,3758,1699,2059,7879,92,NA
26145,"Saginaw County, Michigan",189821,92665,97156,32839,131068,19474,7758,1804,948,186426,4734,3602,8336,33469,14441,19028,79772,540,NA
26147,"St. Clair County, Michigan",160257,80273,79984,35483,114600,14300,6869,1204,427,158988,4928,2581,7509,18761,8524,10237,71975,450,0
26149,"St. Joseph County, Michigan",60887,30671,30216,30171,41125,4415,2142,311,198,60390,3209,2304,5513,7714,3522,4192,27239,185,NA
26151,"Sanilac County, Michigan",40759,20605,20154,30904,29066,2940,1123,296,80,40399,1674,1376,3050,6004,2547,3457,17035,156,NA
26153,"Schoolcraft County, Michigan",8062,4044,4018,33805,6193,807,352,64,24,7967,318,229,547,1272,577,695,3155,11,NA
26155,"Shiawassee County, Michigan",68124,33970,34154,33328,48507,6225,2375,337,365,67601,1708,1535,3243,7402,3491,3911,31454,120,NA
26157,"Tuscola County, Michigan",53218,27048,26170,30698,38485,3977,1558,206,149,52624,1712,955,2667,6443,2936,3507,22372,101,NA
26159,"Van Buren County, Michigan",75636,37837,37799,32361,52266,7423,3303,578,310,75034,3286,2338,5624,10591,4801,5790,33874,104,NA
26161,"Washtenaw County, Michigan",370231,185097,185134,49568,234408,62954,44756,12091,14785,365305,7915,4978,12893,48358,23015,25343,184417,1184,0
26163,"Wayne County, Michigan",1781641,864475,917166,32643,1205390,192328,96057,19423,11594,1770251,58572,43644,102216,355857,161907,193950,742431,9685,0
26165,"Wexford County, Michigan",33766,16966,16800,29617,23571,3061,1275,205,139,33468,1279,1008,2287,4425,2044,2381,13849,94,NA
27001,"Aitkin County, Minnesota",15859,8004,7855,32980,12381,1552,515,143,61,15678,566,314,880,1931,854,1077,5940,76,NA
27003,"Anoka County, Minnesota",363985,183494,180491,43106,249064,56466,17101,2712,2060,361452,9198,6480,15678,22852,10444,12408,190371,1024,NA
27005,"Becker County, Minnesota",35202,17654,17548,38444,24188,4375,1392,416,180,34776,1374,866,2240,3754,1731,2023,16252,89,NA
27007,"Beltrami County, Minnesota",46274,23299,22975,32055,28737,5532,2305,712,486,45679,2110,1599,3709,7160,3315,3845,21007,174,NA
27009,"Benton County, Minnesota",41300,20822,20478,35885,27275,4502,1501,297,150,40680,718,697,1415,3780,1727,2053,22016,137,NA
27011,"Big Stone County, Minnesota",5161,2618,2543,35797,3746,475,194,60,33,5016,139,100,239,523,251,272,2256,18,NA
27013,"Blue Earth County, Minnesota",69022,34934,34088,35182,40559,9412,3362,666,822,68309,1621,807,2428,10756,4977,5779,37318,166,NA
27015,"Brown County, Minnesota",25880,13013,12867,35340,17713,3020,913,239,68,25512,679,370,1049,1918,883,1035,13314,35,NA
27017,"Carlton County, Minnesota",36362,19212,17150,35642,25604,4272,1564,371,219,34673,1038,631,1669,4396,2429,1967,16454,141,NA
27019,"Carver County, Minnesota",107216,53641,53575,55216,70801,23365,8702,1998,1167,106919,1426,1320,2746,4012,1486,2526,58029,559,NA
27021,"Cass County, Minnesota",30288,15590,14698,34505,22211,3915,1130,337,137,30016,1295,1022,2317,3653,1749,1904,12703,179,NA
27023,"Chippewa County, Minnesota",12466,6290,6176,32772,8611,1134,466,61,43,12204,461,377,838,1368,542,826,5806,12,NA
27025,"Chisago County, Minnesota",56927,29651,27276,41814,39754,6656,2119,383,213,55670,1370,793,2163,3471,1539,1932,29403,265,NA
27027,"Clay County, Minnesota",65307,32443,32864,36586,39868,9991,3167,654,814,64745,1513,949,2462,9165,4143,5022,33554,273,NA
27029,"Clearwater County, Minnesota",8541,4314,4227,31879,5793,748,245,33,32,8405,593,457,1050,943,479,464,3576,29,NA
27031,"Cook County, Minnesota",5611,2804,2807,44316,4502,1266,628,49,146,5565,177,106,283,477,239,238,2758,73,NA
27033,"Cottonwood County, Minnesota",11481,5768,5713,32818,7800,1318,319,70,49,11267,302,191,493,1448,600,848,5231,78,NA
27035,"Crow Wing County, Minnesota",66558,33304,33254,36878,48098,8574,3248,915,325,65752,2373,1556,3929,6841,2945,3896,30545,380,NA
27037,"Dakota County, Minnesota",439179,218368,220811,48894,298459,89817,30719,7393,3754,436864,9081,7268,16349,24600,10744,13856,235955,1502,0
27039,"Dodge County, Minnesota",20893,10622,10271,42838,13896,3107,921,98,85,20775,632,369,1001,1018,572,446,11295,55,0
27041,"Douglas County, Minnesota",39081,19714,19367,41889,27956,5526,1634,473,308,38561,841,552,1393,3281,1276,2005,19442,104,NA
27043,"Faribault County, Minnesota",13931,7120,6811,35307,9905,1615,405,55,45,13657,412,314,726,1555,658,897,6728,54,NA
27045,"Fillmore County, Minnesota",21251,10804,10447,35645,14574,2279,896,123,97,20840,1000,652,1652,1805,881,924,10541,106,NA
27047,"Freeborn County, Minnesota",30857,15429,15428,36751,21959,2625,793,277,54,30418,1079,928,2007,2895,1261,1634,14440,127,NA
27049,"Goodhue County, Minnesota",47697,23905,23792,40087,33717,6173,2306,616,275,46847,1375,1133,2508,4253,1872,2381,23597,143,NA
27051,"Grant County, Minnesota",6091,3133,2958,36750,4339,606,156,37,27,6046,214,94,308,607,261,346,2864,25,NA
27053,"Hennepin County, Minnesota",1270787,633454,637333,55199,885895,292492,123007,31392,18807,1261222,33395,25974,59369,122904,57141,65763,690929,6386,NA
27055,"Houston County, Minnesota",18826,9473,9353,39340,13482,2685,697,134,81,18615,564,345,909,1337,553,784,9853,74,NA
27057,"Hubbard County, Minnesota",21479,11006,10473,36944,15654,3032,1168,272,160,21265,788,450,1238,2143,1135,1008,9402,55,NA
27059,"Isanti County, Minnesota",41257,20955,20302,38609,28725,4173,1095,199,192,41092,1236,871,2107,3591,1556,2035,20699,147,NA
27061,"Itasca County, Minnesota",45054,22891,22163,34528,32773,5232,2137,481,236,44307,1393,868,2261,5161,2324,2837,18780,301,0
27063,"Jackson County, Minnesota",9990,5127,4863,37818,7176,1255,293,76,32,9875,249,146,395,958,521,437,5193,20,NA
27065,"Kanabec County, Minnesota",16145,8076,8069,33805,11514,1074,530,88,33,15961,451,324,775,1549,788,761,7466,63,NA
27067,"Kandiyohi County, Minnesota",43686,22189,21497,35814,29348,5365,1605,449,181,42977,1558,1053,2611,4640,1836,2804,21810,140,NA
27069,"Kittson County, Minnesota",4191,2096,2095,35565,2981,563,196,46,6,4033,117,60,177,443,158,285,2030,17,NA
27071,"Koochiching County, Minnesota",12072,6099,5973,36515,9123,1188,305,56,9,11852,382,328,710,1375,623,752,5539,80,NA
27073,"Lac qui Parle County, Minnesota",6736,3439,3297,37520,4894,770,166,56,25,6598,130,69,199,570,220,350,3142,32,NA
27075,"Lake County, Minnesota",10915,5608,5307,39930,8206,1397,571,110,60,10740,326,202,528,921,398,523,4850,27,NA
27077,"Lake of the Woods County, Minnesota",3786,2018,1768,35308,2906,466,109,24,18,3735,126,51,177,399,153,246,1912,9,NA
27079,"Le Sueur County, Minnesota",28795,14650,14145,41400,19934,3466,1037,294,119,28619,848,794,1642,2123,859,1264,15133,68,NA
27081,"Lincoln County, Minnesota",5630,2874,2756,35638,3946,619,203,33,27,5454,165,135,300,496,241,255,2761,9,NA
27083,"Lyon County, Minnesota",25352,12519,12833,35256,16191,3203,820,101,330,25056,760,841,1601,3017,1081,1936,12595,167,NA
27085,"McLeod County, Minnesota",36727,18448,18279,39361,25543,3176,1221,338,96,36362,1086,772,1858,2587,1058,1529,18781,181,NA
27087,"Mahnomen County, Minnesota",5389,2762,2627,24710,3239,314,97,20,13,5355,398,335,733,1083,526,557,1963,10,NA
27089,"Marshall County, Minnesota",9017,4578,4439,35920,6311,917,195,36,20,8917,240,125,365,655,344,311,4245,29,NA
27091,"Martin County, Minnesota",19960,10076,9884,35152,14226,2185,744,200,154,19738,659,437,1096,2305,1127,1178,9657,58,NA
27093,"Meeker County, Minnesota",23352,12031,11321,37233,15925,2195,728,194,73,23026,700,482,1182,1736,830,906,11624,40,NA
27095,"Mille Lacs County, Minnesota",26680,13608,13072,33933,18447,2083,813,112,65,26266,847,598,1445,2871,1178,1693,12727,119,NA
27097,"Morrison County, Minnesota",34023,17343,16680,34269,23694,2922,835,289,93,33598,891,581,1472,3448,1482,1966,16347,179,NA
27099,"Mower County, Minnesota",40082,20512,19570,33921,26677,4275,1558,316,250,39563,1007,828,1835,4665,2116,2549,19181,119,NA
27101,"Murray County, Minnesota",8170,4110,4060,38783,5815,971,198,42,44,8082,223,188,411,595,258,337,3979,46,NA
27103,"Nicollet County, Minnesota",34380,17372,17008,41658,22326,5191,1578,428,596,34079,670,605,1275,3308,1967,1341,18663,351,NA
27105,"Nobles County, Minnesota",22194,11393,10801,29786,13986,1841,423,64,56,21842,1378,1252,2630,2665,1085,1580,10420,90,NA
27107,"Norman County, Minnesota",6457,3343,3114,36245,4463,786,155,15,20,6318,255,139,394,562,261,301,3046,26,NA
27109,"Olmsted County, Minnesota",162307,79676,82631,49799,109809,29258,13739,5791,3551,160411,3126,3046,6172,12551,5274,7277,85332,790,NA
27111,"Otter Tail County, Minnesota",60072,30382,29690,37202,42869,7778,2431,782,395,59337,1730,1298,3028,5110,2432,2678,27776,363,NA
27113,"Pennington County, Minnesota",13995,7035,6960,37342,9696,1391,410,94,11,13798,278,158,436,1325,653,672,7317,210,NA
27115,"Pine County, Minnesota",29090,15605,13485,32335,21460,2317,790,106,91,27830,1026,655,1681,2933,1462,1471,12619,136,NA
27117,"Pipestone County, Minnesota",9380,4617,4763,34973,6244,882,217,102,80,9203,369,250,619,1198,481,717,4368,10,NA
27119,"Polk County, Minnesota",31128,15992,15136,34273,20982,4095,1114,190,196,30457,781,669,1450,3468,1471,1997,14969,219,NA
27121,"Pope County, Minnesota",11312,5798,5514,38905,8222,1249,408,76,108,11107,204,151,355,1067,563,504,5730,45,NA
27123,"Ramsey County, Minnesota",547202,269113,278089,43203,367944,99680,43151,11346,10383,542912,16756,11927,28683,68789,31335,37454,277111,1697,0
27125,"Red Lake County, Minnesota",3912,2031,1881,35198,2734,393,71,5,5,3906,84,24,108,363,210,153,1945,10,NA
27127,"Redwood County, Minnesota",15428,7751,7677,33175,10368,1560,363,91,60,15159,606,439,1045,1519,770,749,7246,76,NA
27129,"Renville County, Minnesota",14707,7557,7150,34554,10268,1448,285,73,38,14387,406,270,676,1489,596,893,7014,95,NA
27131,"Rice County, Minnesota",67152,34493,32659,37050,43025,8107,3205,781,794,64757,2239,1676,3915,5503,2390,3113,32398,359,NA
27133,"Rock County, Minnesota",9659,4701,4958,38472,6488,1295,377,81,26,9422,213,182,395,827,374,453,4914,47,NA
27135,"Roseau County, Minnesota",15294,8070,7224,36125,10505,1672,334,80,12,15108,515,213,728,1563,689,874,7760,123,NA
27137,"St. Louis County, Minnesota",200122,101050,99072,37850,137528,27655,10775,2902,2224,196802,4461,2830,7291,26458,12889,13569,95204,562,NA
27139,"Scott County, Minnesota",151347,75749,75598,51259,98511,29695,9619,1933,991,149789,2660,2365,5025,7517,3259,4258,83336,655,NA
27141,"Sherburne County, Minnesota",97820,50268,47552,41412,64190,12484,3901,746,371,95948,1854,1300,3154,5570,2196,3374,52791,274,NA
27143,"Sibley County, Minnesota",14950,7624,7326,37919,10409,1492,269,70,27,14828,432,241,673,1278,569,709,7742,71,NA
27145,"Stearns County, Minnesota",158622,80483,78139,36087,97939,18295,6576,1493,1495,157136,4185,2511,6696,19300,8553,10747,82627,356,NA
27147,"Steele County, Minnesota",37396,18799,18597,40146,25211,4713,1804,480,151,36988,923,430,1353,3121,1547,1574,18758,81,NA
27149,"Stevens County, Minnesota",9682,4977,4705,38425,5784,1174,259,117,105,9588,252,227,479,1095,513,582,4965,48,NA
27151,"Swift County, Minnesota",9806,5031,4775,35595,6827,1298,203,46,15,9648,325,240,565,1034,550,484,4576,28,NA
27153,"Todd County, Minnesota",25277,13100,12177,30812,17552,1838,555,127,84,25018,1228,1118,2346,2988,1375,1613,11052,224,NA
27155,"Traverse County, Minnesota",3345,1660,1685,36023,2341,278,65,28,8,3244,48,30,78,273,123,150,1569,20,NA
27157,"Wabasha County, Minnesota",21460,10876,10584,40471,15468,2839,970,204,117,21262,579,290,869,1606,776,830,11055,57,NA
27159,"Wadena County, Minnesota",14108,6998,7110,28011,9372,1351,244,95,31,13750,445,399,844,1642,861,781,6104,56,NA
27161,"Waseca County, Minnesota",18953,9140,9813,35814,13088,2150,515,144,66,18146,406,293,699,1198,483,715,9427,164,NA
27163,"Washington County, Minnesota",268651,133828,134823,54418,182135,56173,22249,4739,4065,265915,5266,3916,9182,12377,5686,6691,139002,1066,NA
27165,"Watonwan County, Minnesota",11205,5708,5497,34363,7565,1024,212,93,47,11066,623,637,1260,1467,564,903,5196,24,NA
27167,"Wilkin County, Minnesota",6454,3426,3028,38317,4515,847,199,37,10,6340,114,51,165,856,317,539,3139,50,NA
27169,"Winona County, Minnesota",49792,24786,25006,34889,31020,6520,2517,375,451,49328,1546,1011,2557,6518,2927,3591,27040,247,NA
27171,"Wright County, Minnesota",142543,72791,69752,43067,92801,21553,7002,1331,818,141809,3319,3040,6359,6771,2767,4004,75733,356,NA
27173,"Yellow Medicine County, Minnesota",9569,4849,4720,36737,6612,932,278,44,28,9452,206,164,370,941,468,473,4644,22,NA
28001,"Adams County, Mississippi",29425,13867,15558,22924,20302,2428,1207,198,286,27454,1713,1764,3477,7461,2966,4495,9965,84,NA
28003,"Alcorn County, Mississippi",34717,16911,17806,27320,24069,2716,1096,326,102,33957,2434,2192,4626,5791,2359,3432,14245,156,NA
28005,"Amite County, Mississippi",12683,5948,6735,24135,9134,403,354,57,30,12560,796,634,1430,3398,1409,1989,3724,6,NA
28007,"Attala County, Mississippi",17842,8537,9305,27625,11712,1345,476,65,10,17494,942,798,1740,4103,1572,2531,6886,129,NA
28009,"Benton County, Mississippi",7637,3780,3857,24690,5418,331,175,67,23,7538,608,434,1042,1328,546,782,3225,25,NA
28011,"Bolivar County, Mississippi",30688,14462,16226,25440,20052,3006,1500,697,245,29880,2246,2106,4352,9054,3586,5468,10635,116,NA
28013,"Calhoun County, Mississippi",13193,6523,6670,24192,9191,699,344,2,54,12927,830,656,1486,2426,1036,1390,5599,9,NA
28015,"Carroll County, Mississippi",9930,5307,4623,29588,7391,1043,203,75,9,9539,442,270,712,2084,1181,903,3525,6,NA
28017,"Chickasaw County, Mississippi",17024,8270,8754,21968,11468,963,231,43,56,16498,907,848,1755,4392,1751,2641,6566,136,NA
28019,"Choctaw County, Mississippi",8208,4080,4128,27628,5759,576,302,17,103,8052,628,368,996,1543,674,869,3131,38,NA
28021,"Claiborne County, Mississippi",9044,4405,4639,17250,5119,432,483,188,38,8958,904,842,1746,2419,1144,1275,2466,6,NA
28023,"Clarke County, Mississippi",15553,7289,8264,26435,10758,922,335,74,33,15431,971,1194,2165,3176,1003,2173,5980,135,NA
28025,"Clay County, Mississippi",18598,8803,9795,24702,12731,1443,579,169,102,18290,1105,1004,2109,4214,1662,2552,6979,29,NA
28027,"Coahoma County, Mississippi",21264,9982,11282,22701,13433,1699,835,109,48,20974,1454,1350,2804,7623,3362,4261,7411,0,NA
28029,"Copiah County, Mississippi",28210,13135,15075,28072,18528,2874,779,216,85,28026,2256,1788,4044,6353,2733,3620,10527,178,NA
28031,"Covington County, Mississippi",18323,9001,9322,24147,12184,1336,453,48,77,17987,1135,653,1788,4251,1731,2520,7108,76,NA
28033,"DeSoto County, Mississippi",186214,90194,96020,34989,122411,22045,9043,1452,1059,184978,8370,8163,16533,18083,7349,10734,92131,575,NA
28035,"Forrest County, Mississippi",77917,36624,41293,28197,47240,7234,4381,1113,813,77139,4994,3819,8813,16868,6334,10534,35362,1872,NA
28037,"Franklin County, Mississippi",7690,3870,3820,26844,5254,621,200,37,8,7602,545,286,831,1805,869,936,2529,86,NA
28039,"George County, Mississippi",24547,12440,12107,24756,16155,1891,531,131,34,23865,1760,1495,3255,4986,2376,2610,8328,112,NA
28041,"Greene County, Mississippi",13672,8378,5294,18257,10020,723,281,134,0,9922,613,784,1397,1824,848,976,3214,230,NA
28043,"Grenada County, Mississippi",21474,10391,11083,27128,14635,1936,1010,254,31,21199,1365,1345,2710,4669,2039,2630,8902,147,NA
28045,"Hancock County, Mississippi",46010,22379,23631,36883,33638,4431,2832,555,378,45556,2731,1957,4688,6263,2555,3708,20582,588,NA
28047,"Harrison County, Mississippi",208748,102341,106407,30120,140048,21413,10245,1919,1157,201371,15421,13046,28467,37450,16084,21366,91384,913,0
28049,"Hinds County, Mississippi",226541,106310,120231,27943,147715,26376,13704,3271,2919,224294,14581,13451,28032,45809,19795,26014,96567,332,NA
28051,"Holmes County, Mississippi",16848,8123,8725,20132,10747,1149,330,52,54,16601,1196,818,2014,5598,2756,2842,5279,88,NA
28053,"Humphreys County, Mississippi",7744,3538,4206,24506,5085,469,405,67,6,7651,563,626,1189,2453,998,1455,2518,24,NA
28055,"Issaquena County, Mississippi",1206,773,433,13539,1046,30,23,0,1,853,53,56,109,176,118,58,174,0,NA
28057,"Itawamba County, Mississippi",23888,11861,12027,33243,15997,1438,769,117,117,23526,1484,997,2481,2324,853,1471,10630,35,NA
28059,"Jackson County, Mississippi",143721,71078,72643,31509,98824,15190,5765,1410,954,141507,9749,8510,18259,22256,9927,12329,61439,469,NA
28061,"Jasper County, Mississippi",16320,8167,8153,24068,11321,1213,354,99,21,16220,957,868,1825,2785,1376,1409,6314,58,NA
28063,"Jefferson County, Mississippi",7207,3448,3759,19366,4926,519,385,31,37,6739,374,387,761,2139,964,1175,2102,27,NA
28065,"Jefferson Davis County, Mississippi",11291,5386,5905,22693,8072,567,453,102,21,11165,781,640,1421,2579,1163,1416,4431,69,NA
28067,"Jones County, Mississippi",67152,32780,34372,26063,44140,5519,2755,633,249,66308,3768,3555,7323,13933,6218,7715,27751,255,NA
28069,"Kemper County, Mississippi",8980,4614,4366,22046,5930,492,357,78,54,8511,541,719,1260,1778,829,949,3192,112,NA
28071,"Lafayette County, Mississippi",56172,27066,29106,32536,32280,7803,3995,1059,1695,55489,2897,2160,5057,9967,4506,5461,24693,70,NA
28073,"Lamar County, Mississippi",64425,30879,33546,37681,43319,9135,3832,879,710,63565,4674,3425,8099,10759,4426,6333,29912,1054,NA
28075,"Lauderdale County, Mississippi",72741,35314,37427,26590,49448,6411,2600,767,323,69464,3819,3071,6890,17290,7287,10003,29647,911,NA
28077,"Lawrence County, Mississippi",11933,5840,6093,24809,8086,601,448,41,34,11918,949,704,1653,2683,1243,1440,4037,100,NA
28079,"Leake County, Mississippi",21335,10586,10749,25662,14465,1448,888,46,69,20809,1857,1457,3314,4335,2067,2268,8014,100,NA
28081,"Lee County, Mississippi",83343,39817,43526,33209,55410,10079,3844,1139,630,82071,4788,4404,9192,11039,4581,6458,38045,143,NA
28083,"Leflore County, Mississippi",27920,13124,14796,23281,17405,1640,1268,319,119,27362,2669,1267,3936,8524,3511,5013,10240,38,NA
28085,"Lincoln County, Mississippi",34855,16669,18186,25775,23899,2960,1392,144,89,34438,2481,2312,4793,7675,3382,4293,13497,191,NA
28087,"Lowndes County, Mississippi",58547,27946,30601,29750,38896,6283,2869,631,373,56375,3127,2857,5984,10235,4220,6015,24604,259,NA
28089,"Madison County, Mississippi",109257,52683,56574,46538,73232,20780,9283,3693,2528,108358,4280,3694,7974,10534,4448,6086,53113,472,NA
28091,"Marion County, Mississippi",24362,11794,12568,23055,16676,1043,621,91,124,23619,1960,1739,3699,5362,2285,3077,8800,247,NA
28093,"Marshall County, Mississippi",33980,16852,17128,27680,23704,2062,935,105,213,32613,2349,1418,3767,6181,2841,3340,13832,48,NA
28095,"Monroe County, Mississippi",34168,16511,17657,27619,23671,2478,923,357,47,33623,1959,1577,3536,5557,2317,3240,13500,11,NA
28097,"Montgomery County, Mississippi",9803,4674,5129,24126,6714,606,433,71,23,9667,571,363,934,2337,882,1455,3384,82,NA
28099,"Neshoba County, Mississippi",28970,13754,15216,23538,18167,1356,1232,119,75,28391,1883,1729,3612,7938,3619,4319,10776,546,NA
28101,"Newton County, Mississippi",21275,10313,10962,28364,13646,1354,727,24,101,20995,1674,1327,3001,4803,1969,2834,8429,85,NA
28103,"Noxubee County, Mississippi",10261,4716,5545,19804,6679,643,236,13,0,10072,894,989,1883,2337,1011,1326,3788,139,NA
28105,"Oktibbeha County, Mississippi",51388,25696,25692,28221,26082,5842,3420,488,1843,50888,2404,1625,4029,13133,6841,6292,21814,153,NA
28107,"Panola County, Mississippi",33157,15990,17167,25822,22135,2175,783,555,37,32859,2675,1801,4476,6712,3454,3258,11587,22,NA
28109,"Pearl River County, Mississippi",56351,27679,28672,27549,38640,4357,1461,166,174,55733,3562,3712,7274,8663,3648,5015,22433,612,NA
28111,"Perry County, Mississippi",11511,5766,5745,24935,7743,528,286,21,0,11196,692,892,1584,2304,918,1386,3972,206,NA
28113,"Pike County, Mississippi",40098,18918,21180,23013,25894,2468,1420,291,155,39400,2707,2288,4995,11875,5223,6652,14632,417,NA
28115,"Pontotoc County, Mississippi",31202,15198,16004,26359,20499,2226,1230,160,44,30947,1965,1761,3726,5166,2172,2994,13607,140,NA
28117,"Prentiss County, Mississippi",24945,12270,12675,27979,16541,1896,758,273,130,24654,1240,918,2158,3866,1513,2353,10261,113,NA
28119,"Quitman County, Mississippi",6113,2877,3236,18546,4174,425,108,57,10,5922,555,380,935,1789,801,988,2126,18,NA
28121,"Rankin County, Mississippi",157185,76152,81033,36605,108893,22947,9187,2183,1332,151805,7158,6952,14110,14417,6099,8318,76431,266,NA
28123,"Scott County, Mississippi",27943,13871,14072,23043,17818,1279,506,95,95,27661,2111,1581,3692,6030,2526,3504,11275,282,NA
28125,"Sharkey County, Mississippi",3910,1950,1960,22203,2511,283,79,10,31,3809,457,317,774,1025,518,507,1474,0,NA
28127,"Simpson County, Mississippi",25889,12507,13382,27920,17639,2044,577,128,155,25467,1474,1767,3241,4321,2009,2312,10225,264,NA
28129,"Smith County, Mississippi",14310,6747,7563,25394,9800,742,624,38,15,14179,1223,899,2122,2578,1047,1531,5298,52,NA
28131,"Stone County, Mississippi",18360,9371,8989,25768,11853,986,548,75,85,17776,1036,1185,2221,3660,1690,1970,6656,32,NA
28133,"Sunflower County, Mississippi",25867,13798,12069,18851,17621,1768,1101,130,59,22431,1624,973,2597,6347,2755,3592,8599,48,NA
28135,"Tallahatchie County, Mississippi",12621,6735,5886,20348,8721,595,367,49,7,12113,1353,575,1928,3095,1576,1519,4407,12,NA
28137,"Tate County, Mississippi",28094,13587,14507,28306,18279,1762,1330,126,83,27716,1752,1822,3574,4352,2088,2264,11725,35,NA
28139,"Tippah County, Mississippi",21769,10594,11175,27762,14263,1422,620,96,122,21582,1481,1578,3059,4013,1936,2077,9100,182,NA
28141,"Tishomingo County, Mississippi",18837,9169,9668,26896,13416,1091,658,131,105,18546,1013,1219,2232,3561,1697,1864,7399,17,NA
28143,"Tunica County, Mississippi",9787,4835,4952,20086,6189,773,164,93,17,9686,710,556,1266,3002,1170,1832,3954,18,NA
28145,"Union County, Mississippi",27880,13752,14128,27373,18512,2285,699,126,165,27568,1716,1065,2781,3388,1615,1773,12007,27,NA
28147,"Walthall County, Mississippi",13888,6957,6931,25673,9323,1028,547,114,15,13719,844,589,1433,2783,1070,1713,4834,176,NA
28149,"Warren County, Mississippi",44341,21320,23021,31701,30071,4988,2077,391,589,43849,2573,2317,4890,7923,3554,4369,19159,175,NA
28151,"Washington County, Mississippi",44604,21015,23589,23190,29380,3818,1576,366,292,43933,3220,2667,5887,12788,5578,7210,16403,110,NA
28153,"Wayne County, Mississippi",19760,9600,10160,24479,12605,1262,877,184,178,19668,2124,1458,3582,4343,1677,2666,7398,228,NA
28155,"Webster County, Mississippi",9942,4754,5188,27836,6755,727,401,55,27,9848,710,617,1327,1550,769,781,3990,82,NA
28157,"Wilkinson County, Mississippi",8531,4588,3943,22479,6148,448,204,14,39,7442,307,426,733,1601,539,1062,2773,54,NA
28159,"Winston County, Mississippi",17741,8562,9179,27743,12329,1492,518,76,60,17245,962,939,1901,4490,1852,2638,6340,300,NA
28161,"Yalobusha County, Mississippi",12499,5990,6509,24719,8961,631,394,65,16,12210,870,746,1616,2510,1202,1308,4991,11,NA
28163,"Yazoo County, Mississippi",27467,16207,11260,19836,19377,1690,450,143,18,22626,2026,1076,3102,6569,2914,3655,8844,233,NA
29001,"Adair County, Missouri",25299,12112,13187,28976,13868,2132,1528,288,808,25084,1049,972,2021,5438,2202,3236,10035,110,NA
29003,"Andrew County, Missouri",18069,9113,8956,33722,12659,2090,898,136,182,17785,673,449,1122,1346,485,861,8499,25,NA
29005,"Atchison County, Missouri",5270,2666,2604,32549,3857,609,158,45,10,5191,309,293,602,600,218,382,2521,29,NA
29007,"Audrain County, Missouri",24873,11771,13102,27133,17336,1775,667,131,91,23611,2017,1519,3536,4255,1958,2297,10706,147,NA
29009,"Barry County, Missouri",34701,17540,17161,30932,24415,2330,948,215,145,34425,2401,2104,4505,6330,3083,3247,14783,47,NA
29011,"Barton County, Missouri",11683,5781,5902,25637,7997,1064,321,42,37,11568,654,678,1332,2558,1024,1534,4603,84,NA
29013,"Bates County, Missouri",16101,8064,8037,27333,11069,1015,461,35,25,15781,827,842,1669,2993,1285,1708,6860,91,NA
29015,"Benton County, Missouri",19616,10001,9615,31484,15146,1260,853,75,91,19386,1378,882,2260,3396,1855,1541,6959,112,NA
29017,"Bollinger County, Missouri",10658,5298,5360,24647,7616,539,170,42,140,10548,559,532,1091,1570,649,921,4464,20,NA
29019,"Boone County, Missouri",184043,89484,94559,37393,111010,30976,15075,4261,4879,182763,7235,4886,12121,31074,13922,17152,95304,281,NA
29021,"Buchanan County, Missouri",84544,42811,41733,31886,57316,9300,2819,790,474,81843,5690,4768,10458,13398,5912,7486,38201,285,NA
29023,"Butler County, Missouri",42280,20654,21626,25242,28995,2563,1025,219,224,41738,2977,2559,5536,8718,3423,5295,17147,160,NA
29025,"Caldwell County, Missouri",8876,4549,4327,29673,6078,684,279,49,10,8705,562,393,955,1392,669,723,3747,45,NA
29027,"Callaway County, Missouri",44517,23158,21359,31874,30868,4979,2252,246,200,42124,2386,1811,4197,3854,1426,2428,20411,95,NA
29029,"Camden County, Missouri",43227,21504,21723,35927,33043,4896,1728,440,389,42777,2941,2508,5449,5726,2770,2956,17783,337,NA
29031,"Cape Girardeau County, Missouri",81703,39940,41763,32619,52784,11341,4644,989,779,80492,3028,2547,5575,11340,5114,6226,40636,191,NA
29033,"Carroll County, Missouri",8513,4262,4251,30403,5968,796,378,18,46,8426,273,320,593,793,277,516,3823,21,NA
29035,"Carter County, Missouri",5299,2591,2708,27150,3586,337,195,0,0,5251,460,384,844,1069,458,611,2311,16,NA
29037,"Cass County, Missouri",108205,53087,55118,38766,73862,13604,5617,815,542,107308,4822,4379,9201,7440,3052,4388,53652,455,NA
29039,"Cedar County, Missouri",14314,7313,7001,27243,9906,995,619,91,12,14094,1205,1049,2254,2586,1444,1142,5168,137,NA
29041,"Chariton County, Missouri",7417,3706,3711,28616,5227,714,378,23,6,7183,318,264,582,953,471,482,3172,18,NA
29043,"Christian County, Missouri",89568,43917,45651,35587,60588,11572,5828,1084,828,89032,3966,3695,7661,7682,3629,4053,43032,285,0
29045,"Clark County, Missouri",6693,3459,3234,26417,4607,384,180,8,23,6613,507,301,808,720,339,381,2832,19,NA
29047,"Clay County, Missouri",253085,125225,127860,40278,172370,39614,15875,3073,1675,251465,9889,9602,19491,20681,9513,11168,131772,895,NA
29049,"Clinton County, Missouri",21155,10619,10536,31924,14647,2320,716,163,73,20722,993,874,1867,2333,1090,1243,9070,24,NA
29051,"Cole County, Missouri",76890,38954,37936,35519,53377,12288,5086,1096,637,73130,2675,2419,5094,6795,2715,4080,37693,503,NA
29053,"Cooper County, Missouri",16893,8535,8358,27471,11557,1809,671,58,160,15460,778,738,1516,2004,854,1150,7186,82,NA
29055,"Crawford County, Missouri",23023,11414,11609,29581,16167,1500,552,127,18,22670,1717,1410,3127,3305,1623,1682,9009,116,NA
29057,"Dade County, Missouri",7598,3845,3753,28731,5543,633,132,19,14,7436,503,332,835,1267,617,650,3055,8,NA
29059,"Dallas County, Missouri",17158,8402,8756,24646,11925,831,597,132,28,16910,1246,1397,2643,3484,1434,2050,6291,252,NA
29061,"Daviess County, Missouri",8418,4222,4196,29497,5622,714,375,31,9,8240,585,640,1225,1131,511,620,3625,79,NA
29063,"DeKalb County, Missouri",11838,7127,4711,25591,8719,851,343,31,49,9322,504,415,919,959,401,558,4208,55,NA
29065,"Dent County, Missouri",14509,7257,7252,27342,10217,1110,535,46,76,14354,1125,741,1866,2412,1130,1282,5917,50,NA
29067,"Douglas County, Missouri",11803,5991,5812,27762,8477,927,259,131,18,11689,791,443,1234,2289,1100,1189,4272,92,NA
29069,"Dunklin County, Missouri",28174,13489,14685,26123,18633,1346,981,134,80,27492,2433,2417,4850,6019,2826,3193,10860,58,NA
29071,"Franklin County, Missouri",104858,52478,52380,35679,73034,9991,4196,1101,324,103844,4084,3926,8010,8364,3999,4365,49186,308,NA
29073,"Gasconade County, Missouri",14801,7522,7279,34414,10689,1368,575,74,51,14571,680,504,1184,1722,835,887,6988,98,NA
29075,"Gentry County, Missouri",6219,3034,3185,28968,4199,599,236,24,29,6083,342,364,706,923,380,543,2781,55,NA
29077,"Greene County, Missouri",299188,146659,152529,33275,196608,40170,17081,4462,1972,295407,19182,15832,35014,41987,19896,22091,142571,820,NA
29079,"Grundy County, Missouri",9878,4822,5056,27809,6669,698,249,30,23,9674,879,898,1777,1581,572,1009,3979,48,NA
29081,"Harrison County, Missouri",8190,4127,4063,24530,5627,636,281,27,8,8051,293,305,598,1312,571,741,3335,46,NA
29083,"Henry County, Missouri",22064,10991,11073,31801,15702,1482,847,127,38,21787,1188,1151,2339,3263,1398,1865,9114,19,NA
29085,"Hickory County, Missouri",8452,4307,4145,21476,6468,488,158,5,0,8325,617,597,1214,1464,645,819,2478,0,NA
29087,"Holt County, Missouri",4274,2134,2140,33121,3123,416,186,41,15,4148,225,189,414,391,193,198,1918,6,NA
29089,"Howard County, Missouri",10142,5168,4974,27474,6548,984,524,63,158,10033,618,361,979,1206,529,677,4286,64,NA
29091,"Howell County, Missouri",39960,19454,20506,24389,27255,2909,1364,283,343,39500,3269,2956,6225,9006,3883,5123,15459,207,NA
29093,"Iron County, Missouri",9538,4762,4776,26798,6875,793,330,102,70,9214,548,465,1013,1792,814,978,3879,81,NA
29095,"Jackson County, Missouri",715526,348351,367175,36890,487731,100921,44054,10830,4960,708875,43621,38424,82045,97773,42816,54957,355790,3594,0
29097,"Jasper County, Missouri",122788,60468,62320,28371,80808,13785,4655,913,640,121966,9285,7528,16813,22265,10217,12048,56502,416,0
29099,"Jefferson County, Missouri",226984,113749,113235,36184,157831,24161,9521,1279,964,225199,9890,7943,17833,18549,8388,10161,113879,738,0
29101,"Johnson County, Missouri",54025,27678,26347,30639,31537,5067,3024,281,593,49749,2795,2232,5027,6115,2647,3468,26671,151,0
29103,"Knox County, Missouri",3772,1899,1873,22902,2498,244,110,45,0,3731,504,441,945,470,242,228,1630,20,NA
29105,"Laclede County, Missouri",36060,18027,18033,27790,24359,2858,1061,125,69,35767,2247,1888,4135,6058,2539,3519,15409,246,NA
29107,"Lafayette County, Missouri",32858,16590,16268,34166,22870,3290,1465,250,223,32396,1615,1099,2714,2975,1255,1720,15360,129,NA
29109,"Lawrence County, Missouri",38231,19195,19036,26407,25424,2762,816,262,58,37611,2986,2461,5447,5486,2165,3321,16375,276,NA
29111,"Lewis County, Missouri",9987,5038,4949,24407,6369,666,262,18,8,9800,468,338,806,1513,757,756,4296,43,NA
29113,"Lincoln County, Missouri",60172,30435,29737,33925,40408,5295,1789,165,155,59611,2361,2831,5192,6793,3010,3783,28259,214,NA
29115,"Linn County, Missouri",11892,5823,6069,32065,8178,1042,495,32,35,11738,578,455,1033,1965,885,1080,5457,22,NA
29117,"Livingston County, Missouri",14402,6425,7977,31495,10129,1209,474,185,105,13187,715,702,1417,1377,607,770,6131,62,NA
29119,"McDonald County, Missouri",23381,11840,11541,23210,15568,1347,396,79,20,23224,2844,1961,4805,3912,1943,1969,9528,58,NA
29121,"Macon County, Missouri",15173,7532,7641,27227,10433,1312,348,110,53,14931,950,794,1744,1632,711,921,6511,45,NA
29123,"Madison County, Missouri",12649,6356,6293,31299,8667,882,478,35,0,12374,795,1061,1856,1497,650,847,5399,32,NA
29125,"Maries County, Missouri",8454,4274,4180,30095,6063,701,374,38,0,8388,552,324,876,1463,602,861,3441,11,NA
29127,"Marion County, Missouri",28525,13933,14592,30455,19366,2897,1557,264,70,27946,1316,861,2177,3870,1695,2175,13135,118,NA
29129,"Mercer County, Missouri",3517,1726,1791,26850,2412,321,144,20,9,3447,259,157,416,516,261,255,1484,17,NA
29131,"Miller County, Missouri",24855,12458,12397,29347,17218,2543,861,142,88,24514,1611,1043,2654,3906,1987,1919,11107,139,NA
29133,"Mississippi County, Missouri",12305,6527,5778,21070,8660,814,299,50,22,10825,698,639,1337,2560,1167,1393,4271,6,NA
29135,"Moniteau County, Missouri",15401,7982,7419,28546,10329,1376,501,15,36,14106,1131,1126,2257,1530,648,882,6708,28,NA
29137,"Monroe County, Missouri",8668,4445,4223,28787,6104,759,216,20,5,8519,529,548,1077,1404,637,767,3592,27,NA
29139,"Montgomery County, Missouri",11421,5756,5665,29570,8029,847,384,42,11,11141,609,483,1092,1644,825,819,5004,57,NA
29141,"Morgan County, Missouri",21169,10660,10509,27836,14928,1356,489,159,67,20832,2876,2137,5013,4088,1791,2297,7673,113,NA
29143,"New Madrid County, Missouri",16341,7817,8524,26357,11194,767,609,65,18,15987,1129,1083,2212,2744,1173,1571,6385,13,NA
29145,"Newton County, Missouri",59019,29756,29263,32893,40171,5934,1969,705,308,58432,4044,3766,7810,8618,4080,4538,26066,223,NA
29147,"Nodaway County, Missouri",21140,10575,10565,28136,12492,1968,929,136,221,20423,974,791,1765,3559,1840,1719,9880,44,NA
29149,"Oregon County, Missouri",8783,4367,4416,21405,6160,498,279,70,34,8659,940,757,1697,1973,879,1094,3205,1,NA
29151,"Osage County, Missouri",13374,6899,6475,38553,9050,1583,394,89,22,13311,382,276,658,999,465,534,6686,32,NA
29153,"Ozark County, Missouri",8688,4343,4345,26638,6552,431,232,13,4,8633,846,581,1427,1931,882,1049,2892,34,NA
29155,"Pemiscot County, Missouri",15555,7304,8251,24295,10286,778,314,95,10,15380,1111,883,1994,4489,1895,2594,5504,8,NA
29157,"Perry County, Missouri",18970,9415,9555,30731,13092,1879,631,110,37,18654,745,571,1316,2109,971,1138,8936,47,NA
29159,"Pettis County, Missouri",43059,21606,21453,30991,28595,3114,1610,351,226,42399,3061,2903,5964,6274,2760,3514,19837,298,NA
29161,"Phelps County, Missouri",44843,23629,21214,28335,28068,4591,2764,658,845,44154,2400,1701,4101,7357,3823,3534,18728,81,NA
29163,"Pike County, Missouri",17719,9656,8063,26206,12388,1297,494,79,33,15904,823,637,1460,2513,1220,1293,6653,54,NA
29165,"Platte County, Missouri",107033,53232,53801,47440,73376,20222,9204,1978,1112,105941,3881,2759,6640,7389,3404,3985,56479,473,NA
29167,"Polk County, Missouri",31877,15732,16145,26804,20930,2672,998,226,346,31436,2466,2063,4529,5215,2428,2787,13854,138,NA
29169,"Pulaski County, Missouri",53726,29982,23744,27098,29480,5053,2205,378,306,40837,2915,1505,4420,6382,3519,2863,26813,113,NA
29171,"Putnam County, Missouri",4698,2414,2284,33176,3339,431,150,28,6,4597,323,271,594,564,271,293,2064,10,NA
29173,"Ralls County, Missouri",10356,5301,5055,29625,7423,838,306,20,6,10293,414,417,831,1269,655,614,4518,29,NA
29175,"Randolph County, Missouri",24652,12916,11736,25496,17188,2136,648,87,67,22865,1295,1209,2504,3901,1937,1964,10602,192,NA
29177,"Ray County, Missouri",23122,11611,11511,35601,16094,1717,484,118,116,22907,1320,1034,2354,2784,1163,1621,10894,29,NA
29179,"Reynolds County, Missouri",6102,3177,2925,25204,4529,515,114,13,0,5954,391,377,768,1073,494,579,2365,37,NA
29181,"Ripley County, Missouri",10839,5402,5437,22076,7522,614,179,66,33,10786,878,944,1822,2212,1048,1164,4194,12,NA
29183,"St. Charles County, Missouri",406262,201131,205131,47746,279408,74037,34524,5238,3458,404391,9543,7881,17424,18026,7596,10430,215074,2160,NA
29185,"St. Clair County, Missouri",9330,4737,4593,24845,6828,578,217,25,24,9064,762,580,1342,1412,660,752,3728,20,NA
29186,"Ste. Genevieve County, Missouri",18494,9537,8957,33060,13199,1237,744,115,66,18165,555,470,1025,1660,700,960,8261,50,NA
29187,"St. Francois County, Missouri",66814,35470,31344,25304,47111,4159,2192,588,364,61404,4098,3246,7344,10749,5118,5631,26358,240,NA
29189,"St. Louis County, Missouri",999703,478717,520986,49009,693191,181797,97734,23423,16461,988523,31818,26179,57997,94056,39709,54347,491731,3616,5
29195,"Saline County, Missouri",23219,11642,11577,26704,14738,2492,895,182,114,22845,1046,515,1561,2821,1251,1570,10279,70,NA
29197,"Schuyler County, Missouri",4066,2011,2055,22625,2678,225,54,6,46,4055,372,327,699,414,203,211,1591,49,NA
29199,"Scotland County, Missouri",4720,2304,2416,27808,2923,285,103,28,11,4668,736,716,1452,343,182,161,1923,17,NA
29201,"Scott County, Missouri",38055,18523,19532,29687,25769,3637,1550,166,102,37548,2434,1789,4223,5826,2386,3440,17157,145,NA
29203,"Shannon County, Missouri",7132,3637,3495,23661,5131,430,286,38,13,7072,433,430,863,1021,435,586,2672,3,NA
29205,"Shelby County, Missouri",6049,3076,2973,27547,4163,519,163,31,18,5876,330,255,585,866,398,468,2665,18,NA
29207,"Stoddard County, Missouri",28656,14018,14638,26614,20128,2068,762,137,29,28274,1773,1839,3612,4643,1969,2674,11774,85,NA
29209,"Stone County, Missouri",31314,15415,15899,31865,24357,3379,1127,303,211,31018,1702,1238,2940,4344,1903,2441,11736,44,NA
29211,"Sullivan County, Missouri",5983,3001,2982,25882,4121,379,131,53,30,5823,268,233,501,879,446,433,2621,9,NA
29213,"Taney County, Missouri",56202,26873,29329,28267,38856,6574,1836,477,367,55762,4672,4020,8692,8906,3623,5283,24653,203,NA
29215,"Texas County, Missouri",24828,13096,11732,23621,17662,1531,1009,90,52,23406,2080,1821,3901,4674,2166,2508,8980,76,NA
29217,"Vernon County, Missouri",19777,9763,10014,26515,13356,1454,594,257,67,19363,1507,1692,3199,3454,1685,1769,8229,231,NA
29219,"Warren County, Missouri",35729,17840,17889,34909,24681,3481,1025,109,113,35553,1337,1278,2615,3593,1683,1910,16913,181,NA
29221,"Washington County, Missouri",23580,12260,11320,28191,16328,1298,642,53,11,22601,1549,1142,2691,4182,1914,2268,9003,121,NA
29223,"Wayne County, Missouri",11081,5512,5569,23041,8244,572,265,45,29,10937,712,777,1489,2739,1263,1476,3658,38,NA
29225,"Webster County, Missouri",39265,20016,19249,27611,25319,3082,1296,152,121,38328,2745,2363,5108,5967,2702,3265,15919,186,NA
29227,"Worth County, Missouri",1982,991,991,30800,1400,150,30,28,11,1957,77,94,171,323,140,183,888,6,NA
29229,"Wright County, Missouri",18475,9137,9338,22602,12186,978,514,41,32,18294,1316,1615,2931,3674,1835,1839,6803,86,NA
29510,"St. Louis city, Missouri",298018,144893,153125,36722,215632,46330,24885,6856,5200,293796,16387,13269,29656,58373,26103,32270,151829,1443,NA
30001,"Beaverhead County, Montana",9469,4829,4640,34640,6523,1650,451,173,103,9283,337,271,608,1387,826,561,4559,145,NA
30003,"Big Horn County, Montana",13090,6498,6592,21849,7432,918,417,109,29,12955,1319,1103,2422,3292,1502,1790,4664,58,NA
30005,"Blaine County, Montana",7030,3530,3500,24353,4353,667,263,60,45,6922,731,475,1206,1395,645,750,2563,13,NA
30007,"Broadwater County, Montana",6977,3607,3370,34956,5080,862,216,38,15,6920,400,161,561,633,206,427,3138,36,NA
30009,"Carbon County, Montana",10645,5410,5235,40838,8213,1498,884,113,83,10531,444,309,753,1073,504,569,5137,96,NA
30011,"Carter County, Montana",1332,698,634,28824,994,174,30,5,3,1306,88,89,177,222,112,110,648,12,NA
30013,"Cascade County, Montana",84423,43002,41421,34481,57794,10151,4212,984,605,80468,3405,2113,5518,11172,5382,5790,40313,283,NA
30015,"Chouteau County, Montana",5897,2956,2941,28980,4079,731,211,31,27,5822,225,111,336,878,447,431,2495,9,NA
30017,"Custer County, Montana",11957,6024,5933,34830,8580,1499,599,89,98,11742,546,326,872,1281,679,602,6150,85,NA
30019,"Daniels County, Montana",1535,775,760,33757,1180,221,69,6,11,1510,36,28,64,183,109,74,762,0,NA
30021,"Dawson County, Montana",8915,4607,4308,37705,6222,1018,377,52,85,8617,209,133,342,634,219,415,4405,16,NA
30023,"Deer Lodge County, Montana",9435,5072,4363,30185,7387,1120,305,47,22,9025,355,292,647,2070,1212,858,4088,159,NA
30025,"Fallon County, Montana",2941,1448,1493,42516,1945,248,63,41,0,2863,57,129,186,365,201,164,1423,2,NA
30027,"Fergus County, Montana",11496,5991,5505,34932,8568,1897,321,77,68,11231,1004,579,1583,1651,726,925,5584,64,NA
30029,"Flathead County, Montana",105950,53095,52855,37984,75750,17554,5961,1723,1193,105125,5019,4250,9269,9727,4494,5233,51262,567,NA
30031,"Gallatin County, Montana",119685,62534,57151,47269,77076,25951,9268,2415,3128,119216,5429,3399,8828,12231,6119,6112,67336,511,0
30033,"Garfield County, Montana",976,487,489,33745,687,104,21,21,1,966,60,90,150,91,34,57,517,0,NA
30035,"Glacier County, Montana",13781,6820,6961,21438,8421,1054,574,82,14,13684,1971,2130,4101,3986,1823,2163,4830,17,NA
30037,"Golden Valley County, Montana",841,419,422,31204,654,119,28,2,4,841,67,42,109,135,63,72,377,11,NA
30039,"Granite County, Montana",3368,1724,1644,33776,2581,634,89,45,44,3329,94,115,209,431,291,140,1282,32,NA
30041,"Hill County, Montana",16238,8293,7945,27996,10008,1731,474,85,77,16097,702,454,1156,2679,1427,1252,7348,13,NA
30043,"Jefferson County, Montana",12273,6282,5991,39963,8988,1925,752,190,123,12089,341,347,688,609,281,328,5433,21,NA
30045,"Judith Basin County, Montana",2039,1131,908,36713,1452,325,31,32,8,2039,72,34,106,357,217,140,971,15,NA
30047,"Lake County, Montana",31509,15630,15879,31177,22064,4593,1670,475,310,31314,2675,2155,4830,5901,2991,2910,12938,159,NA
30049,"Lewis and Clark County, Montana",71487,35738,35749,41274,50662,13856,5789,1156,839,70656,1862,2006,3868,6568,3116,3452,35944,366,NA
30051,"Liberty County, Montana",1993,908,1085,34682,1363,287,74,10,0,1966,26,86,112,515,204,311,743,23,NA
30053,"Lincoln County, Montana",20157,10127,10030,29387,15504,1885,536,217,69,19952,1170,1488,2658,3360,1643,1717,7350,101,NA
30055,"McCone County, Montana",1746,913,833,39284,1340,206,74,4,2,1726,58,42,100,42,17,25,904,8,NA
30057,"Madison County, Montana",8742,4593,4149,40358,6951,1547,450,100,102,8684,381,388,769,592,288,304,3962,60,NA
30059,"Meagher County, Montana",1948,1057,891,37498,1490,388,102,47,3,1921,49,72,121,223,120,103,1007,11,NA
30061,"Mineral County, Montana",4652,2430,2222,32940,3459,700,148,36,17,4597,204,143,347,639,275,364,1890,25,NA
30063,"Missoula County, Montana",118541,59633,58908,40311,81050,22620,8687,2881,1873,117712,4417,3230,7647,13756,6637,7119,64821,273,NA
30065,"Musselshell County, Montana",4924,2487,2437,32506,3692,546,165,13,4,4893,198,87,285,576,278,298,1919,28,NA
30067,"Park County, Montana",17320,8723,8597,44273,13482,3373,1168,204,155,17206,812,837,1649,1968,900,1068,8950,75,NA
30069,"Petroleum County, Montana",416,226,190,32590,323,55,20,0,2,416,17,2,19,26,12,14,235,0,NA
30071,"Phillips County, Montana",4233,2247,1986,32450,3028,477,71,51,8,4179,282,110,392,290,146,144,1866,11,NA
30073,"Pondera County, Montana",5987,3013,2974,30424,4119,727,112,54,8,5912,246,191,437,1272,582,690,2570,14,NA
30075,"Powder River County, Montana",1773,876,897,38588,1373,246,89,12,3,1733,61,73,134,220,86,134,894,58,NA
30077,"Powell County, Montana",6998,4455,2543,29675,5489,754,263,37,10,5324,247,104,351,271,146,125,2415,11,NA
30079,"Prairie County, Montana",1283,690,593,28287,950,129,80,4,0,1260,47,26,73,278,161,117,555,24,NA
30081,"Ravalli County, Montana",44876,22535,22341,38555,33694,5826,2833,533,511,44647,2122,2245,4367,4372,1872,2500,19483,234,NA
30083,"Richland County, Montana",11366,5710,5656,34169,7543,855,144,50,19,11357,448,364,812,942,385,557,5451,12,NA
30085,"Roosevelt County, Montana",10799,5464,5335,20564,6182,880,268,57,21,10570,1675,1635,3310,3271,1554,1717,3650,6,NA
30087,"Rosebud County, Montana",8310,4176,4134,27655,5134,620,303,41,34,8231,574,777,1351,1670,789,881,3207,6,NA
30089,"Sanders County, Montana",12615,6532,6083,29707,9732,1372,270,48,70,12489,807,733,1540,2027,901,1126,4045,104,NA
30091,"Sheridan County, Montana",3700,1945,1755,42653,2643,458,116,40,60,3637,206,199,405,356,167,189,1728,40,NA
30093,"Silver Bow County, Montana",35306,18120,17186,35047,24314,4492,1679,344,210,34513,1743,702,2445,5438,2744,2694,16296,267,NA
30095,"Stillwater County, Montana",8978,4560,4418,45245,6538,1348,344,66,156,8903,237,145,382,713,307,406,4243,81,NA
30097,"Sweet Grass County, Montana",3697,1906,1791,35495,2593,453,137,11,11,3669,166,171,337,219,119,100,1793,22,NA
30099,"Teton County, Montana",6238,3087,3151,30874,4253,770,276,36,2,6124,271,252,523,886,341,545,2842,17,NA
30101,"Toole County, Montana",5018,2921,2097,28621,3554,460,211,38,83,4420,201,208,409,468,214,254,2086,5,NA
30103,"Treasure County, Montana",680,359,321,37349,538,156,17,0,0,680,17,16,33,67,27,40,361,4,NA
30105,"Valley County, Montana",7552,3862,3690,30941,5374,899,95,43,17,7447,272,252,524,910,427,483,3358,19,NA
30107,"Wheatland County, Montana",2060,942,1118,28410,1522,219,75,8,13,2029,183,217,400,460,205,255,820,3,NA
30109,"Wibaux County, Montana",1119,542,577,31089,773,132,34,8,0,1099,57,54,111,195,70,125,489,0,NA
30111,"Yellowstone County, Montana",165524,82077,83447,40978,113507,27169,7417,2718,1585,163362,6150,4015,10165,17356,8216,9140,82869,696,NA
31001,"Adams County, Nebraska",31143,15385,15758,34688,20343,3383,1301,452,367,30912,1032,793,1825,3563,1408,2155,15172,146,NA
31003,"Antelope County, Nebraska",6302,3193,3109,32172,4288,561,209,61,47,6244,236,164,400,686,274,412,3227,38,NA
31005,"Arthur County, Nebraska",485,255,230,31210,315,70,25,4,0,485,21,11,32,34,11,23,219,0,NA
31007,"Banner County, Nebraska",670,328,342,38474,510,108,40,6,1,670,13,11,24,49,11,38,348,2,NA
31009,"Blaine County, Nebraska",384,204,180,40093,322,54,13,0,0,384,18,11,29,44,22,22,200,2,NA
31011,"Boone County, Nebraska",5397,2721,2676,36583,3747,444,166,54,10,5303,144,94,238,389,207,182,2748,59,NA
31013,"Box Butte County, Nebraska",10778,5486,5292,32141,7434,1117,166,60,0,10616,469,462,931,1271,405,866,5148,9,NA
31015,"Boyd County, Nebraska",1767,918,849,35198,1343,122,95,2,8,1739,103,41,144,202,65,137,848,3,NA
31017,"Brown County, Nebraska",2691,1324,1367,31772,1988,256,133,18,17,2655,93,100,193,236,77,159,1253,0,NA
31019,"Buffalo County, Nebraska",50103,25127,24976,36327,31028,7178,2439,505,789,49418,2060,1517,3577,5653,2431,3222,27193,151,NA
31021,"Burt County, Nebraska",6717,3358,3359,33457,4723,853,196,41,15,6628,383,255,638,941,485,456,2979,31,NA
31023,"Butler County, Nebraska",8373,4192,4181,39639,5785,1162,216,69,17,8234,247,296,543,647,309,338,4408,25,NA
31025,"Cass County, Nebraska",26749,13586,13163,40941,18457,3756,1566,307,143,26423,987,863,1850,1482,648,834,13699,106,NA
31027,"Cedar County, Nebraska",8375,4291,4084,35820,5583,941,277,44,39,8235,207,290,497,444,173,271,4226,43,NA
31029,"Chase County, Nebraska",3704,1752,1952,34477,2570,433,142,40,12,3638,215,206,421,298,157,141,1688,27,NA
31031,"Cherry County, Nebraska",5473,2815,2658,31424,3749,693,139,90,50,5420,195,273,468,530,200,330,2804,83,NA
31033,"Cheyenne County, Nebraska",9489,4734,4755,30467,6642,1107,377,34,65,9388,326,319,645,1086,389,697,4536,29,NA
31035,"Clay County, Nebraska",6088,3093,2995,36425,4181,638,172,64,28,5981,271,216,487,520,249,271,3030,11,NA
31037,"Colfax County, Nebraska",10563,5742,4821,29436,6596,649,162,15,20,10406,711,389,1100,1057,640,417,5301,44,NA
31039,"Cuming County, Nebraska",9000,4582,4418,34825,6124,1064,305,62,36,8872,361,302,663,678,336,342,4618,10,NA
31041,"Custer County, Nebraska",10566,5314,5252,35562,7313,1394,362,72,59,10457,362,447,809,1177,559,618,5072,64,NA
31043,"Dakota County, Nebraska",21308,10530,10778,29584,12896,1427,315,72,25,21082,1055,719,1774,2354,927,1427,10396,28,NA
31045,"Dawes County, Nebraska",8279,3951,4328,27256,5179,937,501,94,334,8208,371,331,702,964,383,581,4292,70,NA
31047,"Dawson County, Nebraska",24037,12528,11509,34648,15509,1783,517,95,90,23790,1507,1174,2681,3378,1566,1812,12263,166,0
31049,"Deuel County, Nebraska",1858,918,940,38667,1423,209,44,42,1,1851,119,117,236,132,52,80,876,30,NA
31051,"Dixon County, Nebraska",5579,2874,2705,36911,3735,622,158,33,17,5483,283,162,445,518,247,271,2734,9,NA
31053,"Dodge County, Nebraska",37175,18572,18603,33674,24741,3438,1515,297,113,36618,1129,1250,2379,3255,1227,2028,17862,214,NA
31055,"Douglas County, Nebraska",582638,289721,292917,42802,381023,99805,38869,11917,6494,576211,27480,24939,52419,62856,28838,34018,301107,2632,NA
31057,"Dundy County, Nebraska",1825,943,882,36436,1248,187,107,34,0,1797,61,43,104,224,106,118,945,2,NA
31059,"Fillmore County, Nebraska",5557,2789,2768,41909,4136,618,219,92,16,5366,150,114,264,375,156,219,2929,36,NA
31061,"Franklin County, Nebraska",2901,1456,1445,34650,2167,265,127,16,8,2841,128,69,197,421,203,218,1347,36,NA
31063,"Frontier County, Nebraska",2491,1340,1151,30189,1692,292,74,27,3,2468,173,83,256,295,143,152,1171,5,NA
31065,"Furnas County, Nebraska",4630,2344,2286,32494,3285,521,163,19,0,4553,183,192,375,506,254,252,2189,11,NA
31067,"Gage County, Nebraska",21654,10964,10690,33435,15167,2234,546,132,122,21371,724,647,1371,2835,1181,1654,10513,49,NA
31069,"Garden County, Nebraska",1778,861,917,28787,1297,205,82,12,0,1749,135,185,320,168,75,93,696,28,NA
31071,"Garfield County, Nebraska",1833,938,895,31710,1346,327,61,41,0,1772,90,6,96,213,131,82,944,0,NA
31073,"Gosper County, Nebraska",1873,986,887,38057,1445,292,78,19,17,1840,128,84,212,120,39,81,915,41,NA
31075,"Grant County, Nebraska",649,363,286,32905,445,100,11,9,0,649,40,43,83,68,34,34,344,7,NA
31077,"Greeley County, Nebraska",2212,1134,1078,28736,1535,200,32,13,18,2181,63,21,84,271,108,163,986,5,NA
31079,"Hall County, Nebraska",62575,32000,30575,32671,40196,5668,2263,411,215,61882,4204,3179,7383,7860,3354,4506,30635,353,NA
31081,"Hamilton County, Nebraska",9400,4738,4662,34813,6405,1048,398,101,51,9263,291,251,542,510,189,321,4694,26,NA
31083,"Harlan County, Nebraska",3094,1590,1504,38129,2173,378,120,26,9,3048,114,101,215,224,92,132,1479,5,NA
31085,"Hayes County, Nebraska",919,457,462,35135,681,109,10,4,0,919,29,19,48,135,56,79,427,4,NA
31087,"Hitchcock County, Nebraska",2620,1352,1268,30595,1848,254,72,18,4,2584,163,59,222,319,155,164,1126,14,NA
31089,"Holt County, Nebraska",10149,5119,5030,34952,6891,1362,399,101,32,10011,348,248,596,986,503,483,5183,47,NA
31091,"Hooker County, Nebraska",659,322,337,29390,420,109,5,0,0,634,45,7,52,51,27,24,306,2,NA
31093,"Howard County, Nebraska",6476,3314,3162,33509,4497,827,146,25,5,6445,308,154,462,312,150,162,3189,16,NA
31095,"Jefferson County, Nebraska",7185,3475,3710,30363,5169,773,182,15,26,7077,327,315,642,780,307,473,3428,56,NA
31097,"Johnson County, Nebraska",5294,3208,2086,28046,3829,459,217,18,34,4319,157,88,245,265,103,162,2129,9,NA
31099,"Kearney County, Nebraska",6655,3337,3318,37233,4456,1089,256,11,20,6590,213,102,315,619,301,318,3464,23,NA
31101,"Keith County, Nebraska",8303,4218,4085,34905,6130,855,287,70,8,8234,377,165,542,978,411,567,3995,29,NA
31103,"Keya Paha County, Nebraska",987,498,489,33995,633,140,31,6,5,987,25,39,64,85,26,59,441,18,NA
31105,"Kimball County, Nebraska",3395,1774,1621,31290,2506,211,74,0,4,3330,310,226,536,333,123,210,1616,9,NA
31107,"Knox County, Nebraska",8415,4225,4190,31269,5741,744,233,65,44,8246,268,262,530,983,447,536,3930,17,NA
31109,"Lancaster County, Nebraska",322063,162505,159558,38509,201049,51720,20746,4568,5103,317389,10710,10349,21059,36483,16787,19696,173171,863,0
31111,"Lincoln County, Nebraska",34532,17250,17282,33437,23882,3160,1320,223,121,34169,1412,1256,2668,3699,1531,2168,16387,169,0
31113,"Logan County, Nebraska",839,456,383,35645,558,128,11,2,0,839,32,42,74,77,39,38,434,1,NA
31115,"Loup County, Nebraska",629,349,280,28251,461,61,21,8,0,629,25,24,49,50,31,19,320,0,NA
31117,"McPherson County, Nebraska",456,239,217,32675,339,47,12,0,0,456,12,4,16,35,16,19,252,0,NA
31119,"Madison County, Nebraska",35538,17653,17885,34690,23257,3927,1257,249,255,34892,1594,1460,3054,4201,1931,2270,17964,174,0
31121,"Merrick County, Nebraska",7675,3895,3780,31349,5437,607,286,29,25,7571,412,252,664,772,444,328,3800,21,NA
31123,"Morrill County, Nebraska",4562,2449,2113,29741,3126,434,151,20,3,4444,151,119,270,423,189,234,2063,7,NA
31125,"Nance County, Nebraska",3366,1697,1669,32568,2370,289,126,28,7,3288,94,98,192,446,166,280,1607,19,NA
31127,"Nemaha County, Nebraska",7019,3595,3424,36367,4607,966,334,48,56,6928,419,197,616,1001,422,579,3187,11,NA
31129,"Nuckolls County, Nebraska",4092,2046,2046,39201,3020,551,181,26,52,4033,278,135,413,253,120,133,2134,17,NA
31131,"Otoe County, Nebraska",15995,8239,7756,36817,10972,1941,621,133,119,15785,594,266,860,1804,805,999,7967,37,NA
31133,"Pawnee County, Nebraska",2553,1241,1312,29091,1794,228,124,9,5,2519,219,91,310,332,134,198,1051,8,NA
31135,"Perkins County, Nebraska",2860,1480,1380,34696,1965,436,53,9,10,2826,89,61,150,245,97,148,1414,8,NA
31137,"Phelps County, Nebraska",8966,4574,4392,38930,6092,1229,259,56,82,8736,325,138,463,1257,680,577,4446,27,NA
31139,"Pierce County, Nebraska",7301,3691,3610,33513,4940,814,244,14,18,7192,262,226,488,569,252,317,3685,4,NA
31141,"Platte County, Nebraska",34219,17368,16851,35991,22403,3926,1360,178,42,33951,1595,1500,3095,2774,1318,1456,17594,270,NA
31143,"Polk County, Nebraska",5182,2581,2601,34344,3598,487,141,36,4,5099,184,236,420,393,153,240,2683,9,NA
31145,"Red Willow County, Nebraska",10690,5224,5466,34401,7380,1266,311,144,79,10470,641,445,1086,1262,546,716,5284,45,NA
31147,"Richardson County, Nebraska",7850,3981,3869,32336,5672,870,205,50,32,7710,398,353,751,837,327,510,3650,23,NA
31149,"Rock County, Nebraska",1312,647,665,34660,925,211,52,2,0,1285,45,52,97,113,34,79,650,0,NA
31151,"Saline County, Nebraska",14275,7286,6989,32563,9320,1437,503,62,42,14035,986,610,1596,1524,635,889,6999,59,NA
31153,"Sarpy County, Nebraska",191272,96591,94681,43845,123235,32227,14889,2083,1523,186483,5380,3955,9335,10398,4810,5588,103080,653,NA
31155,"Saunders County, Nebraska",22374,11495,10879,41364,15336,3063,1085,176,137,22019,526,438,964,1471,668,803,11676,41,NA
31157,"Scotts Bluff County, Nebraska",36048,17521,18527,33158,24201,4153,1337,392,214,35413,1811,1715,3526,4379,1937,2442,16964,159,NA
31159,"Seward County, Nebraska",17644,9122,8522,36054,11099,2472,748,47,169,17362,454,458,912,1104,495,609,9229,61,NA
31161,"Sheridan County, Nebraska",5102,2558,2544,31699,3595,605,108,40,27,4991,384,218,602,539,289,250,2375,31,NA
31163,"Sherman County, Nebraska",2970,1509,1461,31023,2158,284,98,18,7,2915,186,71,257,318,152,166,1419,12,NA
31165,"Sioux County, Nebraska",1162,571,591,26748,783,141,51,3,0,1162,47,76,123,202,72,130,506,1,NA
31167,"Stanton County, Nebraska",5828,2956,2872,36737,3980,565,185,20,30,5767,138,110,248,404,115,289,3079,10,NA
31169,"Thayer County, Nebraska",5006,2474,2532,32028,3514,554,175,27,35,4882,149,207,356,468,183,285,2405,19,NA
31171,"Thomas County, Nebraska",592,281,311,42187,496,95,16,11,0,592,17,9,26,39,9,30,352,0,NA
31173,"Thurston County, Nebraska",6716,3306,3410,23785,3660,515,156,30,24,6656,671,503,1174,1253,600,653,2632,33,NA
31175,"Valley County, Nebraska",4053,2026,2027,34637,2868,569,101,78,25,4009,168,216,384,353,182,171,2009,23,NA
31177,"Washington County, Nebraska",20884,10389,10495,44206,14264,3435,1073,187,198,20712,539,497,1036,1644,721,923,10853,147,NA
31179,"Wayne County, Nebraska",9701,4867,4834,29985,5479,1151,421,61,156,9663,252,176,428,1381,580,801,5080,10,NA
31181,"Webster County, Nebraska",3410,1749,1661,34652,2401,345,135,20,16,3331,107,86,193,262,118,144,1745,15,NA
31183,"Wheeler County, Nebraska",771,365,406,35158,611,109,35,5,2,771,41,44,85,79,28,51,357,3,NA
31185,"York County, Nebraska",14212,7105,7107,39507,9553,1612,593,105,104,13626,413,305,718,1242,532,710,6866,24,NA
32001,"Churchill County, Nevada",25409,13112,12297,35869,17516,2169,515,348,58,24084,1069,1126,2195,2464,1171,1293,11611,52,NA
32003,"Clark County, Nevada",2265926,1137581,1128345,36615,1560375,271537,98248,27060,15014,2241139,144887,123874,268761,299459,134996,164463,1040510,21327,0
32005,"Douglas County, Nevada",49476,25063,24413,49115,38843,7930,2954,833,453,49227,2024,1503,3527,3678,1713,1965,21142,516,0
32007,"Elko County, Nevada",53600,28070,25530,39001,34678,3642,1605,458,193,52924,2781,1947,4728,5473,2487,2986,25906,320,NA
32009,"Esmeralda County, Nevada",980,529,451,31776,873,133,79,0,0,973,59,43,102,157,129,28,397,4,NA
32011,"Eureka County, Nevada",1622,818,804,32187,1111,108,61,0,0,1616,58,103,161,285,132,153,579,0,NA
32013,"Humboldt County, Nevada",17266,9009,8257,35979,11339,1751,471,76,62,17083,840,823,1663,2448,990,1458,8176,174,NA
32015,"Lander County, Nevada",5728,3109,2619,41561,3854,255,128,131,27,5682,239,111,350,611,290,321,2335,11,NA
32017,"Lincoln County, Nevada",4507,2516,1991,32459,3187,292,197,0,0,4011,310,111,421,288,83,205,1651,30,NA
32019,"Lyon County, Nevada",59435,30802,28633,36330,43054,4970,1502,242,223,59060,2939,2743,5682,6114,2801,3313,25834,127,NA
32021,"Mineral County, Nevada",4568,2124,2444,26662,3263,414,51,13,0,4482,288,207,495,828,400,428,1648,9,NA
32023,"Nye County, Nevada",51698,26290,25408,30751,40380,3372,1270,213,208,51052,2237,2294,4531,7746,3745,4001,16552,397,NA
32027,"Pershing County, Nevada",6587,4293,2294,25896,5013,291,191,16,6,4807,212,289,501,472,236,236,1993,0,NA
32029,"Storey County, Nevada",4095,2149,1946,44539,3113,526,321,87,42,4061,210,69,279,371,168,203,1352,10,NA
32031,"Washoe County, Nevada",486674,247473,239201,44448,339174,66824,29693,7573,6067,483608,26863,21516,48379,52165,24629,27536,244367,4892,0
32033,"White Pine County, Nevada",8997,5195,3802,30668,6727,664,185,0,46,7483,137,168,305,684,271,413,3387,26,NA
32510,"Carson City, Nevada",58249,30199,28050,37677,41987,6883,2371,677,274,55737,3491,2838,6329,6213,2608,3605,26695,309,NA
33001,"Belknap County, New Hampshire",63914,31658,32256,43670,47981,9127,4956,742,502,63100,2783,1605,4388,5408,2543,2865,32144,197,NA
33003,"Carroll County, New Hampshire",50679,25655,25024,48199,39992,8647,4941,738,688,50277,2142,1604,3746,3998,1853,2145,24419,109,NA
33005,"Cheshire County, New Hampshire",76610,37770,38840,40196,54560,11579,5517,929,724,75910,2841,1634,4475,6538,2811,3727,38344,307,NA
33007,"Coos County, New Hampshire",31430,16638,14792,32570,24511,3186,1276,339,202,29606,1510,827,2337,3419,1596,1823,14066,506,NA
33009,"Grafton County, New Hampshire",90836,45104,45732,47080,65142,13805,8730,2614,3052,89948,3716,1790,5506,8361,3797,4564,45358,494,NA
33011,"Hillsborough County, New Hampshire",422733,212276,210457,49675,301873,76111,35731,4904,4645,418659,14619,10956,25575,28465,12373,16092,231932,1763,NA
33013,"Merrimack County, New Hampshire",153918,76723,77195,44391,110798,23235,12637,2972,1955,150487,4650,3598,8248,10722,4694,6028,78773,423,NA
33015,"Rockingham County, New Hampshire",315169,157222,157947,56321,231996,62863,29787,5019,3433,313051,8057,6019,14076,15149,5859,9290,171850,1499,0
33017,"Strafford County, New Hampshire",130965,64834,66131,43338,87852,21650,9755,1208,1406,129324,4316,3067,7383,11112,4719,6393,69543,614,NA
33019,"Sullivan County, New Hampshire",43356,21845,21511,39087,32648,5986,3048,474,335,42874,2183,851,3034,4990,2567,2423,19817,201,NA
34001,"Atlantic County, New Jersey",274339,133897,140442,39699,191583,37957,13994,4139,1541,271937,10787,10021,20808,34989,15095,19894,126468,1368,0
34003,"Bergen County, New Jersey",953243,467592,485651,60222,674596,208030,97521,29083,13811,947568,32940,30044,62984,63825,26338,37487,482857,6048,6
34005,"Burlington County, New Jersey",461853,228468,233385,51549,329081,87020,35832,8652,3667,447132,9982,8171,18153,29718,12154,17564,234607,1931,0
34007,"Camden County, New Jersey",522581,253604,268977,42398,360582,74997,33228,10330,4964,517354,19824,15082,34906,64050,27350,36700,250162,2582,5
34009,"Cape May County, New Jersey",95456,46347,49109,51344,72532,16309,7051,1905,738,93727,2990,2239,5229,8443,4008,4435,42154,754,0
34011,"Cumberland County, New Jersey",153588,78755,74833,32551,103984,12061,4586,794,599,143979,7569,6207,13776,22292,9962,12330,61388,359,0
34013,"Essex County, New Jersey",853374,414982,438392,45946,573215,124500,62058,17690,10116,842469,52772,44436,97208,125228,53192,72036,396088,14318,7
34015,"Gloucester County, New Jersey",302621,148499,154122,45933,207727,48158,18370,4065,2467,301419,7779,5150,12929,22231,10050,12181,152194,1320,NA
34017,"Hudson County, New Jersey",712029,356520,355509,51277,512195,140539,73996,14197,10054,707403,45554,36368,81922,99546,44166,55380,375393,4856,16
34019,"Hunterdon County, New Jersey",129099,63792,65307,68112,93742,30308,15673,3494,2528,126832,1857,1664,3521,4685,2016,2669,66185,331,NA
34021,"Mercer County, New Jersey",383732,189495,194237,50053,259959,62306,36469,6769,9234,378850,15307,11170,26477,41079,17544,23535,181170,1161,0
34023,"Middlesex County, New Jersey",860147,427707,432440,47196,591318,156153,85932,13151,11532,852894,31127,26328,57455,69626,31048,38578,420626,6632,8
34025,"Monmouth County, New Jersey",643064,315742,327322,62998,454185,138371,63454,16729,8054,639171,16974,14909,31883,40595,17090,23505,325055,3144,0
34027,"Morris County, New Jersey",508816,252441,256375,67555,359811,118638,63667,14932,8362,504822,13199,10095,23294,24800,10954,13846,262320,2646,5
34029,"Ocean County, New Jersey",638691,310873,327818,42497,434506,93595,38555,6882,4101,633623,16289,12137,28426,66258,30798,35460,269436,2711,0
34031,"Passaic County, New Jersey",519986,255780,264206,38932,346430,70286,25478,5499,2966,517035,36878,27661,64539,68995,31239,37756,246290,1825,7
34033,"Salem County, New Jersey",64840,32077,32763,37904,45316,6792,2495,656,377,63728,1783,1279,3062,8271,3688,4583,28330,318,NA
34035,"Somerset County, New Jersey",344978,170153,174825,67554,242607,75626,44946,9849,8508,342502,9919,9340,19259,18097,7472,10625,180486,2637,0
34037,"Sussex County, New Jersey",144808,72893,71915,54124,105082,26428,10806,2447,1269,143700,3037,2159,5196,7948,3574,4374,75861,532,0
34039,"Union County, New Jersey",572079,282245,289834,49666,389288,89290,43587,10152,6084,568641,37172,31886,69058,50130,22623,27507,285292,10779,7
34041,"Warren County, New Jersey",109739,54469,55270,45517,79264,18944,7552,1018,605,108970,2877,2605,5482,8373,3716,4657,55352,716,0
35001,"Bernalillo County, New Mexico",674692,332549,342143,36996,469743,93393,53529,12362,12722,666806,31860,24727,56587,109353,50726,58627,320828,2490,0
35003,"Catron County, New Mexico",3635,1903,1732,26678,2925,217,103,96,20,3629,110,217,327,756,254,502,961,60,NA
35005,"Chaves County, New Mexico",64701,32652,32049,26568,41749,4537,2023,512,248,63567,3441,2297,5738,13522,5713,7809,25977,234,NA
35006,"Cibola County, New Mexico",27211,13765,13446,22394,18386,1507,974,180,47,25891,1779,1275,3054,7063,3389,3674,8842,141,NA
35007,"Colfax County, New Mexico",12370,6273,6097,28275,9233,1169,710,123,36,11804,508,381,889,2130,892,1238,4949,173,NA
35009,"Curry County, New Mexico",48327,24945,23382,28045,29818,4028,1872,298,199,44455,2135,1957,4092,9113,3924,5189,21564,83,NA
35011,"De Baca County, New Mexico",1695,1063,632,27710,1139,53,52,0,0,1679,138,12,150,273,126,147,722,12,NA
35013,"Doña Ana County, New Mexico",219870,108834,111036,26900,134344,23076,13243,2110,2437,216833,12644,10892,23536,48732,22098,26634,91502,1019,NA
35015,"Eddy County, New Mexico",61264,31413,29851,36274,39653,4615,2237,128,251,60648,3398,2191,5589,7132,3030,4102,27002,228,NA
35017,"Grant County, New Mexico",28006,14084,13922,29123,20381,3153,1794,228,200,27488,849,541,1390,5538,2429,3109,9731,5,NA
35019,"Guadalupe County, New Mexico",4413,2590,1823,27526,3398,348,96,32,0,3877,95,170,265,801,468,333,1526,44,NA
35021,"Harding County, New Mexico",671,339,332,68690,471,74,66,4,0,670,21,17,38,96,53,43,271,1,NA
35023,"Hidalgo County, New Mexico",4160,2066,2094,25476,2908,330,128,8,26,4045,216,125,341,939,494,445,1629,11,NA
35025,"Lea County, New Mexico",73103,37934,35169,29635,43412,3298,2636,258,146,71343,5329,4562,9891,12557,5586,6971,30122,226,NA
35027,"Lincoln County, New Mexico",20222,9878,10344,31332,15369,2191,1156,216,168,20055,1467,1137,2604,3140,1302,1838,8220,167,NA
35028,"Los Alamos County, New Mexico",19253,9884,9369,71527,13886,3869,3078,317,2410,19078,378,276,654,710,318,392,10197,0,NA
35029,"Luna County, New Mexico",25393,12969,12424,20799,16460,1129,622,180,22,25046,1260,929,2189,5816,2572,3244,8172,52,NA
35031,"McKinley County, New Mexico",72073,35101,36972,19188,45143,3341,1670,335,268,71547,7471,6786,14257,23950,11152,12798,23701,69,NA
35033,"Mora County, New Mexico",4208,1872,2336,28356,3394,258,389,19,33,4208,17,71,88,911,522,389,1312,0,NA
35035,"Otero County, New Mexico",67850,35846,32004,26319,44772,6168,2608,340,280,61374,2924,2729,5653,12457,5585,6872,26803,109,NA
35037,"Quay County, New Mexico",8641,4206,4435,25348,6380,637,339,47,0,8577,424,459,883,2094,872,1222,3422,18,NA
35039,"Rio Arriba County, New Mexico",40285,19854,20431,27878,27682,2941,1889,76,142,40179,1845,1810,3655,8722,3723,4999,15331,222,NA
35041,"Roosevelt County, New Mexico",19142,9583,9559,24954,11171,1453,714,51,61,18764,1464,697,2161,3697,1795,1902,8672,43,NA
35043,"Sandoval County, New Mexico",149460,74086,75374,36603,103937,20227,9759,1781,1640,148743,5402,4434,9836,14965,6381,8584,66313,859,NA
35045,"San Juan County, New Mexico",121798,60435,61363,25008,79736,7345,3825,831,552,120582,8540,6691,15231,29458,14211,15247,44516,152,NA
35047,"San Miguel County, New Mexico",27215,13545,13670,26314,19765,2768,1557,136,240,26799,939,775,1714,6092,2885,3207,10620,106,NA
35049,"Santa Fe County, New Mexico",154481,75375,79106,45402,116573,24664,15429,4868,4198,152956,8339,6659,14998,18751,8619,10132,70746,695,NA
35051,"Sierra County, New Mexico",11506,5822,5684,26396,9168,1075,599,78,58,11246,167,278,445,2834,1475,1359,3546,254,NA
35053,"Socorro County, New Mexico",16453,8366,8087,21792,10697,680,546,67,500,16270,696,389,1085,4812,2554,2258,5045,39,NA
35055,"Taos County, New Mexico",34475,17035,17440,36361,26461,5014,3220,561,325,34273,1448,1262,2710,5087,2368,2719,13876,73,NA
35057,"Torrance County, New Mexico",15203,7805,7398,24657,10624,958,482,45,58,15203,879,415,1294,3219,1536,1683,5431,97,NA
35059,"Union County, New Mexico",4074,2182,1892,20779,2860,278,123,8,35,3591,268,150,418,639,261,378,1315,10,NA
35061,"Valencia County, New Mexico",76613,38604,38009,28817,52270,5911,4126,537,451,75037,2985,2799,5784,13292,5564,7728,28823,425,NA
36001,"Albany County, New York",315041,153405,161636,44101,211845,47712,32349,8000,6032,311626,6237,3168,9405,37608,17430,20178,157506,1069,0
36003,"Allegany County, New York",47222,23892,23330,28506,29967,3833,2867,256,387,46759,1451,1040,2491,7236,3526,3710,18985,202,0
36005,"Bronx County, New York",1443229,683349,759880,25845,943981,127270,56700,10644,5654,1425336,66102,42149,108251,379925,165211,214714,564284,5443,50
36007,"Broome County, New York",198365,98025,100340,33674,131196,20751,13617,2332,2439,195765,4703,2672,7375,35991,16811,19180,84789,677,0
36009,"Cattaraugus County, New York",77000,38652,38348,30286,53128,5788,4057,415,472,76281,3040,2014,5054,13016,6310,6706,32488,297,NA
36011,"Cayuga County, New York",76171,39143,37028,35579,55374,7335,4526,409,453,73224,1764,1259,3023,9744,4354,5390,34081,498,NA
36013,"Chautauqua County, New York",127440,63496,63944,30718,89404,12068,7677,844,1127,125655,3951,2915,6866,21513,9942,11571,53861,596,NA
36015,"Chemung County, New York",83584,41704,41880,34304,58945,7943,5154,771,608,81195,2280,1242,3522,12118,5406,6712,35625,258,NA
36017,"Chenango County, New York",47096,23663,23433,32708,33959,3325,2344,372,163,46571,985,669,1654,5747,2595,3152,20856,96,NA
36019,"Clinton County, New York",79839,41064,38775,34834,55243,8494,4964,951,604,76204,1642,843,2485,9586,4221,5365,35098,226,NA
36021,"Columbia County, New York",61469,31068,30401,49093,47307,8970,5838,1671,737,60224,1308,1058,2366,6157,3104,3053,29002,461,0
36023,"Cortland County, New York",46755,23310,23445,31594,29274,4387,2920,376,467,46317,940,773,1713,5575,2577,2998,22643,138,NA
36025,"Delaware County, New York",44637,22763,21874,33332,33158,4409,2922,510,447,44260,1080,923,2003,6295,3137,3158,18859,128,NA
36027,"Dutchess County, New York",296467,148112,148355,49379,210886,43496,29315,5306,4090,289578,7230,5193,12423,24165,11043,13122,145279,1580,0
36029,"Erie County, New York",951232,463713,487519,39703,671368,135561,80323,16175,12211,943208,16857,10276,27133,127623,58472,69151,455254,4150,0
36031,"Essex County, New York",37314,19297,18017,39049,28930,5079,2742,786,413,35545,1072,386,1458,3670,1681,1989,16875,86,NA
36033,"Franklin County, New York",47459,25027,22432,30411,33832,4152,2656,369,316,44416,1626,1053,2679,7719,3502,4217,18873,255,NA
36035,"Fulton County, New York",53280,26734,26546,33282,38665,4454,2442,383,194,52559,1120,766,1886,7280,3782,3498,23844,118,NA
36037,"Genesee County, New York",58204,29171,29033,35053,41797,5638,3390,469,186,57666,1256,528,1784,5974,2501,3473,28247,343,NA
36039,"Greene County, New York",48067,24926,23141,38587,36429,5892,3182,624,352,45728,989,623,1612,4713,1979,2734,21390,333,NA
36041,"Hamilton County, New York",5090,2569,2521,37326,4107,548,330,36,45,5080,135,102,237,541,299,242,2223,8,NA
36043,"Herkimer County, New York",60293,30207,30086,34394,43013,5719,3281,351,268,59775,1650,1138,2788,7140,3427,3713,27448,224,NA
36045,"Jefferson County, New York",117445,62226,55219,32775,74585,11185,6105,1036,483,104283,3432,2220,5652,14310,6680,7630,54156,698,NA
36047,"Kings County, New York",2679620,1279425,1400195,43165,1860601,448448,227665,52111,23500,2665912,97236,70903,168139,503524,224415,279109,1222797,11666,36
36049,"Lewis County, New York",26690,13520,13170,31127,18480,1987,1333,142,88,26434,761,387,1148,3459,1641,1818,11676,139,NA
36051,"Livingston County, New York",61980,31139,30841,35673,41890,6471,4414,654,803,60384,1201,855,2056,6667,2970,3697,28236,333,NA
36053,"Madison County, New York",68020,33809,34211,37666,46161,6623,4273,790,721,67526,1356,844,2200,5961,2919,3042,30850,169,NA
36055,"Monroe County, New York",756406,367653,388753,40937,525640,116878,70267,14994,10675,749922,14376,9324,23700,98468,43083,55385,365663,2722,0
36057,"Montgomery County, New York",49624,24788,24836,29961,34309,3799,2323,445,218,48957,1539,1216,2755,7383,3429,3954,21665,215,NA
36059,"Nassau County, New York",1389160,683660,705500,60456,969981,254707,148541,47052,17453,1380687,30515,24133,54648,73765,31804,41961,689613,5693,20
36061,"New York County, New York",1645867,788264,857603,89702,1267630,410095,242911,93367,49071,1637167,42568,32292,74860,252677,113591,139086,870794,10732,52
36063,"Niagara County, New York",212230,104348,107882,36556,152567,24288,13706,1957,1286,210420,2962,1950,4912,27046,11728,15318,98566,849,NA
36065,"Oneida County, New York",231055,115677,115378,35284,159897,24775,14167,2491,2244,224645,4622,2909,7531,31854,14772,17082,100408,499,NA
36067,"Onondaga County, New York",472637,229648,242989,39371,324436,65547,40065,8624,5617,468161,10251,5950,16201,63066,27386,35680,222274,2184,0
36069,"Ontario County, New York",112288,55283,57005,43046,80008,15907,10538,1630,1719,111411,2121,1562,3683,9803,4278,5525,54283,326,NA
36071,"Orange County, New York",401237,200761,200476,40410,256375,46559,27120,4272,2964,393572,11347,7949,19296,51059,23567,27492,183472,1363,5
36073,"Orleans County, New York",40148,20464,19684,33054,29333,3434,1398,195,194,38241,1260,807,2067,4801,2235,2566,17535,170,NA
36075,"Oswego County, New York",118037,59486,58551,33904,80294,10192,5483,1059,475,117308,2925,2044,4969,19320,8512,10808,53261,945,NA
36077,"Otsego County, New York",59678,29157,30521,34573,39352,7088,4509,987,676,59041,1719,1296,3015,7090,2910,4180,26908,143,NA
36079,"Putnam County, New York",97942,49280,48662,53105,70716,17119,10611,1478,1077,97552,2346,1112,3458,6129,2648,3481,49087,375,0
36081,"Queens County, New York",2360826,1155898,1204928,39201,1709759,365140,171327,38281,19715,2347232,118247,86737,204984,272926,120698,152228,1112766,10352,39
36083,"Rensselaer County, New York",160943,80545,80398,42728,113385,23380,13006,2075,1633,159298,3196,1782,4978,17789,7256,10533,78978,716,NA
36085,"Richmond County, New York",492925,241783,251142,43199,344639,72848,37678,7993,3256,489423,11249,7930,19179,50556,22216,28340,221119,2139,0
36087,"Rockland County, New York",337326,166981,170345,44212,208539,49010,28453,7613,3477,335633,8099,5734,13833,50181,25355,24826,144661,1037,0
36089,"St. Lawrence County, New York",108670,55702,52968,29827,71483,8590,6201,809,1184,105895,3600,2753,6353,16674,8299,8375,43767,507,NA
36091,"Saratoga County, New York",236328,117525,118803,51931,170815,41136,25518,3772,3718,234394,4178,2340,6518,15248,6673,8575,123295,455,NA
36093,"Schenectady County, New York",159447,78328,81119,39791,109680,20727,12151,2369,2309,157890,3922,2287,6209,18013,8052,9961,75018,658,0
36095,"Schoharie County, New York",29970,15033,14937,37280,21509,2907,1907,303,252,29887,731,533,1264,2904,1366,1538,13550,52,NA
36097,"Schuyler County, New York",17855,8987,8868,35062,13283,1674,1138,211,229,17751,445,339,784,2781,1306,1475,7982,52,NA
36099,"Seneca County, New York",33651,17613,16038,34212,24400,3301,1662,306,135,31776,1523,1206,2729,4144,1865,2279,14480,149,NA
36101,"Steuben County, New York",93584,46984,46600,35282,66493,8548,6387,1129,1126,92649,3004,1608,4612,12388,6138,6250,41256,260,NA
36103,"Suffolk County, New York",1524486,756707,767779,54127,1067104,225180,140324,34103,16845,1514839,38363,27818,66181,97307,41971,55336,765877,7203,7
36105,"Sullivan County, New York",78725,40863,37862,37854,55556,9021,4704,1131,571,76047,2400,1893,4293,11211,4883,6328,33267,119,NA
36107,"Tioga County, New York",48344,24193,24151,37691,34747,5426,3180,264,274,47997,1069,544,1613,4848,2090,2758,22405,160,NA
36109,"Tompkins County, New York",102555,50314,52241,40781,61156,15045,11336,2095,6681,101829,1781,1624,3405,14232,6312,7920,48267,362,0
36111,"Ulster County, New York",182153,90973,91180,43168,134090,26089,16063,3409,2158,178527,6720,4331,11051,25740,12445,13295,83839,1062,NA
36113,"Warren County, New York",65684,32658,33026,44183,49282,8787,6259,1245,387,64986,1500,981,2481,5607,2797,2810,31577,160,NA
36115,"Washington County, New York",61310,31806,29504,34233,45270,5655,3018,646,246,58747,1922,1296,3218,6641,2951,3690,27765,277,NA
36117,"Wayne County, New York",91324,45865,45459,36834,65234,10056,5421,492,339,90646,3012,2271,5283,9958,4771,5187,42736,295,NA
36119,"Westchester County, New York",997904,487019,510885,67776,695064,177680,123967,41549,16568,987426,28174,20012,48186,83412,34981,48431,485163,4463,13
36121,"Wyoming County, New York",40338,21526,18812,35228,29511,3251,1765,212,150,37905,960,684,1644,4037,1640,2397,17810,126,NA
36123,"Yates County, New York",24713,12105,12608,32291,16746,2386,1281,218,140,24418,2201,2103,4304,3347,1570,1777,10662,109,NA
37001,"Alamance County, North Carolina",171779,82328,89451,32105,115744,21972,7160,1081,1425,170768,8899,7732,16631,23763,10019,13744,80839,477,0
37003,"Alexander County, North Carolina",36505,18896,17609,30510,26366,2910,932,99,99,35278,1755,1458,3213,4295,1980,2315,15849,165,NA
37005,"Alleghany County, North Carolina",10989,5340,5649,32330,8508,1143,517,42,63,10880,1001,458,1459,2127,960,1167,4345,0,NA
37007,"Anson County, North Carolina",22200,11246,10954,22854,15790,1380,352,31,35,20267,1683,942,2625,3913,1820,2093,8565,32,NA
37009,"Ashe County, North Carolina",26759,13254,13505,29683,20539,2588,1326,121,235,26452,1652,1265,2917,3734,1694,2040,11435,65,NA
37011,"Avery County, North Carolina",17679,9666,8013,30578,13603,1852,765,256,161,15387,1236,1016,2252,1653,728,925,6209,117,NA
37013,"Beaufort County, North Carolina",44711,21485,23226,32936,32694,3996,1714,435,220,44314,2801,2195,4996,7524,3269,4255,19091,195,NA
37015,"Bertie County, North Carolina",17818,9227,8591,27311,13425,1459,701,54,15,16381,1154,803,1957,3500,1680,1820,6177,161,NA
37017,"Bladen County, North Carolina",29807,14326,15481,26544,21347,2992,915,271,145,29499,1736,1201,2937,7188,3078,4110,10567,6,NA
37019,"Brunswick County, North Carolina",139721,67404,72317,42263,111828,22776,10262,2125,1066,138693,6940,5197,12137,12578,5382,7196,55354,857,NA
37021,"Buncombe County, North Carolina",269449,130266,139183,39495,200084,51168,24245,6749,3942,265600,16774,13331,30105,29543,13970,15573,130073,951,NA
37023,"Burke County, North Carolina",87799,44022,43777,30633,64552,7983,3720,738,316,85522,4850,4352,9202,14453,6874,7579,38812,328,NA
37025,"Cabarrus County, North Carolina",226396,111333,115063,38690,150268,36005,14665,2453,1705,224718,9979,7931,17910,18865,7427,11438,111840,1049,0
37027,"Caldwell County, North Carolina",80716,40091,40625,29125,58269,7183,2172,407,285,79843,5061,3953,9014,10551,4659,5892,35284,569,NA
37029,"Camden County, North Carolina",10547,5494,5053,34117,7290,1194,500,0,81,10465,174,210,384,619,341,278,4860,73,NA
37031,"Carteret County, North Carolina",68353,33661,34692,39817,52162,10353,4505,1083,684,66855,3879,2897,6776,6489,2473,4016,30080,306,NA
37033,"Caswell County, North Carolina",22747,11831,10916,27503,16679,1645,626,198,104,21607,1199,936,2135,3288,1603,1685,9225,171,NA
37035,"Catawba County, North Carolina",161011,79315,81696,34369,112106,19436,5683,1583,1100,159382,9342,9524,18866,20605,9695,10910,74280,1076,0
37037,"Chatham County, North Carolina",76754,36955,39799,53291,56742,14026,8107,2010,2251,76139,4087,2628,6715,7877,3534,4343,34963,407,0
37039,"Cherokee County, North Carolina",28868,14246,14622,28752,22423,3511,1568,119,100,28528,2701,1933,4634,4770,2182,2588,11047,244,NA
37041,"Chowan County, North Carolina",13835,6602,7233,32479,10603,1606,709,118,133,13582,462,430,892,2837,1092,1745,5623,37,NA
37043,"Clay County, North Carolina",11186,5347,5839,34382,8551,1503,743,137,81,11114,961,736,1697,1493,663,830,4364,138,NA
37045,"Cleveland County, North Carolina",99527,48106,51421,27522,68628,8415,3774,562,555,99058,5715,5348,11063,17926,7435,10491,42455,264,NA
37047,"Columbus County, North Carolina",50827,25276,25551,24236,35890,3483,1309,174,250,48228,3765,3068,6833,10149,4524,5625,18489,108,NA
37049,"Craven County, North Carolina",101098,50563,50535,33963,68006,10281,5618,1039,510,94448,4841,3856,8697,13507,5930,7577,44932,707,NA
37051,"Cumberland County, North Carolina",335207,166798,168409,29681,208267,36206,14838,3024,1936,301181,16746,15859,32605,55872,23782,32090,153731,1666,0
37053,"Currituck County, North Carolina",28616,14503,14113,40352,20448,3797,1391,235,110,28168,1931,1215,3146,2409,1104,1305,14296,68,NA
37055,"Dare County, North Carolina",37160,18548,18612,45669,27944,7818,3120,600,349,36873,2624,1637,4261,2398,1384,1014,18731,122,NA
37057,"Davidson County, North Carolina",169498,83345,86153,31024,119381,17220,4872,1736,612,167837,10432,7944,18376,23343,9946,13397,75568,529,NA
37059,"Davie County, North Carolina",43030,21018,22012,36570,30752,5358,2032,348,313,42638,2395,1954,4349,4958,2149,2809,19362,107,NA
37061,"Duplin County, North Carolina",49312,24368,24944,25428,33381,3796,1217,128,159,48955,4027,3224,7251,9024,4253,4771,21072,304,NA
37063,"Durham County, North Carolina",325101,156231,168870,43945,225746,61099,34750,9618,11661,319748,19857,16688,36545,38202,16882,21320,168520,1774,0
37065,"Edgecombe County, North Carolina",49067,22979,26088,25813,34110,4421,1229,340,64,48482,3314,2288,5602,10652,4557,6095,20021,383,NA
37067,"Forsyth County, North Carolina",383739,182947,200792,35600,257771,55140,23393,6401,6083,380486,21882,18050,39932,56760,24715,32045,175739,1506,0
37069,"Franklin County, North Carolina",69680,34827,34853,33313,48583,7856,2830,458,373,68760,4200,2521,6721,6614,2885,3729,32053,123,NA
37071,"Gaston County, North Carolina",228972,111225,117747,33806,158986,27972,9244,1485,1040,226685,11865,11198,23063,27965,11776,16189,106701,702,NA
37073,"Gates County, North Carolina",10509,5212,5297,28091,7757,408,235,17,30,10439,455,322,777,1482,665,817,4479,31,NA
37075,"Graham County, North Carolina",8047,3994,4053,25835,5809,588,165,20,30,7920,827,574,1401,894,371,523,3048,46,NA
37077,"Granville County, North Carolina",61161,31552,29609,31604,43383,7032,2628,399,205,57504,3474,2605,6079,8245,3683,4562,26260,156,NA
37079,"Greene County, North Carolina",20407,11779,8628,21972,14601,1176,373,70,54,17821,1726,1282,3008,4016,1854,2162,8021,8,NA
37081,"Guilford County, North Carolina",539557,256731,282826,36563,357540,85562,36371,7073,6584,535116,25251,23744,48995,78085,32191,45894,257749,2431,0
37083,"Halifax County, North Carolina",48772,23755,25017,25504,34748,3483,1488,342,154,47636,2941,1983,4924,11347,4907,6440,17869,358,NA
37085,"Harnett County, North Carolina",134718,67115,67603,29678,88532,13404,5272,887,586,128330,7498,6424,13922,18893,8425,10468,57835,445,0
37087,"Haywood County, North Carolina",62152,30253,31899,34609,46815,8218,4032,748,459,61670,3903,3032,6935,7440,3231,4209,27174,238,NA
37089,"Henderson County, North Carolina",116469,56226,60243,37457,87179,18490,7892,1904,1317,115358,7766,6416,14182,13087,5663,7424,53627,824,NA
37091,"Hertford County, North Carolina",21633,10908,10725,25313,15136,1430,726,127,142,20397,1151,1050,2201,3959,1706,2253,8435,257,NA
37093,"Hoke County, North Carolina",52612,26017,26595,27991,33996,4660,1802,235,163,48939,2833,2567,5400,8840,3913,4927,21569,178,NA
37095,"Hyde County, North Carolina",4636,2394,2242,19258,3706,425,73,10,20,4042,282,274,556,1209,468,741,1325,42,NA
37097,"Iredell County, North Carolina",187839,93283,94556,40959,130349,29342,9712,2202,1368,186437,9700,7613,17313,17505,7683,9822,90895,602,NA
37099,"Jackson County, North Carolina",42388,20991,21397,31384,27605,4787,2314,599,533,42130,3690,2668,6358,7476,3603,3873,18158,167,NA
37101,"Johnston County, North Carolina",219042,108299,110743,35078,146407,27955,8231,1191,1025,217351,13715,10559,24274,23185,10179,13006,106454,554,0
37103,"Jones County, North Carolina",9263,4636,4627,28373,6848,811,218,24,25,9151,682,463,1145,1622,804,818,3815,32,NA
37105,"Lee County, North Carolina",63560,31219,32341,30083,43222,6339,2123,304,316,62428,4334,4202,8536,9934,4400,5534,28339,214,NA
37107,"Lenoir County, North Carolina",55071,26348,28723,26697,38258,3974,1451,158,160,54018,3174,2671,5845,12093,5157,6936,22131,89,NA
37109,"Lincoln County, North Carolina",87933,43881,44052,40574,63079,11737,3714,630,358,87299,4502,2960,7462,8062,4146,3916,41524,359,NA
37111,"McDowell County, North Carolina",44629,22521,22108,29047,32612,4060,1437,246,115,43416,2909,2571,5480,6463,2862,3601,18297,97,NA
37113,"Macon County, North Carolina",37088,18191,18897,32623,27929,4474,1780,315,262,36909,3095,2618,5713,5661,2289,3372,15362,241,NA
37115,"Madison County, North Carolina",21414,10613,10801,33821,15610,3298,1230,291,210,21157,1221,688,1909,2566,1168,1398,9348,42,NA
37117,"Martin County, North Carolina",21992,10172,11820,25769,16019,1790,569,37,82,21852,1016,770,1786,4425,1772,2653,8885,57,NA
37119,"Mecklenburg County, North Carolina",1115403,540310,575093,48625,755037,234207,95508,21332,9722,1109341,67388,60120,127508,115796,49833,65963,590774,5974,0
37121,"Mitchell County, North Carolina",14989,7418,7571,31696,11148,1536,709,84,128,14905,818,762,1580,1959,1014,945,6316,53,NA
37123,"Montgomery County, North Carolina",25839,12560,13279,29346,18303,2417,954,112,129,24985,1932,1531,3463,4035,1632,2403,10716,28,NA
37125,"Moore County, North Carolina",100759,49243,51516,42094,72283,17050,8529,1932,1305,96032,4627,3369,7996,9380,3763,5617,44256,1519,NA
37127,"Nash County, North Carolina",95015,45908,49107,31987,66173,10109,3497,552,366,93892,6430,4428,10858,13523,6046,7477,42444,318,NA
37129,"New Hanover County, North Carolina",228134,109251,118883,43378,158599,44834,16335,5079,2590,225509,13206,10564,23770,28197,12613,15584,115016,593,NA
37131,"Northampton County, North Carolina",17528,8481,9047,29047,13261,1430,743,101,82,16783,1084,792,1876,3132,1348,1784,6529,113,NA
37133,"Onslow County, North Carolina",203686,113368,90318,29214,110214,19410,7042,843,985,164165,9323,7645,16968,23314,10084,13230,104468,1903,NA
37135,"Orange County, North Carolina",145919,69888,76031,50449,92484,25510,17407,6257,7902,145210,5507,3697,9204,16503,6407,10096,69679,840,0
37137,"Pamlico County, North Carolina",12317,6337,5980,32677,9769,1214,849,168,159,11529,469,606,1075,1588,803,785,4402,106,NA
37139,"Pasquotank County, North Carolina",40454,20076,20378,31762,27830,4783,1703,467,304,38787,2395,1768,4163,4370,1989,2381,18395,116,NA
37141,"Pender County, North Carolina",61592,31258,30334,36352,43541,8374,3136,576,373,60018,3101,2468,5569,7050,3351,3699,27872,42,NA
37143,"Perquimans County, North Carolina",13053,6233,6820,31919,9828,1072,758,59,36,13008,739,649,1388,1724,673,1051,5011,130,NA
37145,"Person County, North Carolina",39131,18879,20252,33456,27970,3539,910,267,185,38777,1879,1389,3268,6665,2712,3953,18393,610,NA
37147,"Pitt County, North Carolina",171196,80857,90339,32224,105366,21025,9398,2639,1854,169567,9157,8049,17206,32978,13673,19305,80221,532,NA
37149,"Polk County, North Carolina",19538,9098,10440,35916,15320,3285,1318,285,219,19242,1030,881,1911,2116,809,1307,8355,40,NA
37151,"Randolph County, North Carolina",144403,71792,72611,29131,100308,11923,3970,610,309,143154,10257,8275,18532,21016,9407,11609,65475,555,NA
37153,"Richmond County, North Carolina",43149,21082,22067,24416,29335,3131,1432,293,200,41942,2968,1354,4322,9631,4382,5249,17681,99,NA
37155,"Robeson County, North Carolina",117573,56878,60695,21998,75885,7243,3097,445,307,115834,9514,7270,16784,30923,13689,17234,43118,455,NA
37157,"Rockingham County, North Carolina",91209,44392,46817,29239,66036,6974,2581,423,220,90123,5239,3737,8976,16806,7104,9702,38800,875,NA
37159,"Rowan County, North Carolina",147067,73080,73987,31108,101628,14877,4439,981,618,144570,8285,7369,15654,23443,10579,12864,65043,421,NA
37161,"Rutherford County, North Carolina",64680,31503,33177,28873,46748,6080,2570,334,261,63638,3931,3642,7573,11655,4880,6775,26021,369,NA
37163,"Sampson County, North Carolina",59317,29674,29643,25969,39775,4136,1382,206,203,58353,5459,3739,9198,12959,5906,7053,24170,185,NA
37165,"Scotland County, North Carolina",34222,17382,16840,24464,23188,2115,928,131,182,32547,2454,1542,3996,8360,3916,4444,12134,111,NA
37167,"Stanly County, North Carolina",62723,31635,31088,30857,44097,5840,1898,355,172,61266,4067,2810,6877,8369,3548,4821,28124,55,NA
37169,"Stokes County, North Carolina",44696,21931,22765,32601,32996,3471,1489,193,166,44163,2012,1797,3809,5281,2174,3107,19243,150,NA
37171,"Surry County, North Carolina",71429,34926,36503,30274,50638,6190,2455,318,259,70512,4737,4148,8885,12615,5710,6905,31099,87,NA
37173,"Swain County, North Carolina",14130,6913,7217,28624,9664,1207,656,120,58,13900,1654,1680,3334,2747,1364,1383,5620,119,NA
37175,"Transylvania County, North Carolina",33131,16013,17118,36660,25529,6065,2555,532,312,32695,2422,2017,4439,4305,1949,2356,13645,61,NA
37177,"Tyrrell County, North Carolina",3389,1847,1542,22403,2542,198,61,4,48,2724,123,212,335,430,190,240,1176,0,NA
37179,"Union County, North Carolina",240109,119375,120734,43957,154639,39363,15261,3457,1375,238941,11093,10045,21138,16125,7455,8670,119069,780,NA
37181,"Vance County, North Carolina",42492,19917,22575,26771,28800,3502,1328,215,83,42080,2992,2266,5258,7862,3170,4692,17668,177,NA
37183,"Wake County, North Carolina",1132103,555563,576540,50188,764919,258183,123119,23781,20622,1124056,51632,41731,93363,90909,40688,50221,591910,5655,0
37185,"Warren County, North Carolina",18803,9379,9424,29771,14047,1606,724,29,76,18018,1141,876,2017,3819,1613,2206,6896,116,NA
37187,"Washington County, North Carolina",11051,5659,5392,26209,7927,848,158,29,83,10891,513,435,948,2354,1422,932,3906,6,NA
37189,"Watauga County, North Carolina",54540,27205,27335,30807,31195,7527,4212,718,1432,54272,3254,1836,5090,12190,6514,5676,25360,99,NA
37191,"Wayne County, North Carolina",117480,58498,58982,30540,78268,10860,3819,528,439,112551,7428,6251,13679,20581,8888,11693,52846,293,NA
37193,"Wilkes County, North Carolina",66125,32914,33211,27592,47754,5550,1708,223,343,65228,4455,3178,7633,11148,4710,6438,28177,130,0
37195,"Wilson County, North Carolina",78667,37576,41091,28715,54088,7053,3178,488,350,77659,4847,4508,9355,15714,7265,8449,34109,325,NA
37197,"Yadkin County, North Carolina",37280,18709,18571,32680,26525,2841,692,119,92,36917,2344,2163,4507,5102,2443,2659,16725,86,NA
37199,"Yancey County, North Carolina",18538,9203,9335,31037,13849,1988,864,162,84,18393,913,941,1854,2811,1468,1343,7632,206,NA
38001,"Adams County, North Dakota",2190,1123,1067,35830,1576,209,76,26,11,2114,133,82,215,284,148,136,1030,0,NA
38003,"Barnes County, North Dakota",10826,5436,5390,38626,7518,1624,377,69,88,10607,398,263,661,1329,558,771,5416,39,NA
38005,"Benson County, North Dakota",5960,3080,2880,24490,3366,495,170,4,26,5945,275,200,475,1614,784,830,2014,111,NA
38007,"Billings County, North Dakota",839,456,383,36923,608,121,18,17,20,839,23,23,46,92,48,44,418,8,NA
38009,"Bottineau County, North Dakota",6411,3358,3053,45506,4468,881,196,61,39,6275,275,226,501,499,235,264,2976,82,NA
38011,"Bowman County, North Dakota",2975,1483,1492,38585,2027,305,108,13,16,2904,162,138,300,310,123,187,1413,23,NA
38013,"Burke County, North Dakota",2184,1146,1038,50714,1545,317,55,4,6,2183,56,26,82,142,71,71,1039,4,NA
38015,"Burleigh County, North Dakota",98443,49666,48777,43615,66365,17514,5256,1339,626,96409,2928,1613,4541,7526,3081,4445,50478,224,NA
38017,"Cass County, North Dakota",186328,94537,91791,43474,117253,34136,11372,2308,2152,184481,6902,3978,10880,19590,9456,10134,107914,1634,NA
38019,"Cavalier County, North Dakota",3691,1919,1772,44346,2643,540,69,6,8,3585,111,99,210,358,134,224,1691,11,NA
38021,"Dickey County, North Dakota",5003,2497,2506,35649,3194,666,134,18,35,4860,191,229,420,433,195,238,2511,51,NA
38023,"Divide County, North Dakota",2195,1118,1077,43850,1547,232,68,3,27,2116,84,117,201,140,73,67,971,8,NA
38025,"Dunn County, North Dakota",4049,2228,1821,50132,2918,430,94,14,16,3981,391,342,733,270,149,121,1881,8,NA
38027,"Eddy County, North Dakota",2345,1225,1120,34852,1710,341,93,21,5,2263,83,53,136,275,106,169,1098,25,NA
38029,"Emmons County, North Dakota",3297,1671,1626,38027,2454,322,99,18,5,3232,89,133,222,217,111,106,1536,0,NA
38031,"Foster County, North Dakota",3388,1712,1676,41796,2448,459,77,3,9,3280,91,32,123,274,106,168,1794,16,NA
38033,"Golden Valley County, North Dakota",1734,859,875,35953,1278,207,86,8,0,1711,11,24,35,215,131,84,808,23,NA
38035,"Grand Forks County, North Dakota",72927,37845,35082,37159,43156,10451,3320,932,1142,70861,2541,1482,4023,9708,4764,4944,39811,195,NA
38037,"Grant County, North Dakota",2320,1171,1149,37252,1733,308,45,8,4,2274,91,17,108,349,181,168,1034,12,NA
38039,"Griggs County, North Dakota",2309,1176,1133,43383,1688,319,122,6,4,2218,46,37,83,144,42,102,1106,16,NA
38041,"Hettinger County, North Dakota",2477,1183,1294,40931,1839,236,69,15,6,2312,109,97,206,236,129,107,1121,14,NA
38043,"Kidder County, North Dakota",2391,1319,1072,32974,1664,257,45,9,0,2391,70,42,112,297,157,140,1009,0,NA
38045,"LaMoure County, North Dakota",4135,2134,2001,37453,2956,603,109,7,30,4058,116,134,250,488,206,282,2036,16,NA
38047,"Logan County, North Dakota",1849,924,925,33240,1360,266,45,16,4,1773,32,21,53,145,70,75,846,7,NA
38049,"McHenry County, North Dakota",5326,2736,2590,39973,3755,589,123,11,5,5253,155,170,325,540,257,283,2501,16,NA
38051,"McIntosh County, North Dakota",2529,1259,1270,37236,1969,244,50,28,7,2412,123,47,170,329,152,177,1293,8,NA
38053,"McKenzie County, North Dakota",14081,7684,6397,44409,8610,1662,300,130,29,13948,1162,1029,2191,1856,1055,801,6700,41,NA
38055,"McLean County, North Dakota",9781,5076,4705,40448,7093,1294,232,35,17,9652,203,262,465,661,307,354,4413,49,NA
38057,"Mercer County, North Dakota",8366,4241,4125,39783,5913,894,236,17,31,8203,449,508,957,785,283,502,3756,0,NA
38059,"Morton County, North Dakota",33192,16895,16297,42603,22764,4788,893,339,65,32524,1168,612,1780,2647,1122,1525,18192,79,NA
38061,"Mountrail County, North Dakota",9648,5066,4582,39603,6150,927,305,98,64,9575,973,674,1647,1182,599,583,4339,27,NA
38063,"Nelson County, North Dakota",3025,1496,1529,37130,2207,469,98,44,20,2929,115,58,173,316,140,176,1350,27,NA
38065,"Oliver County, North Dakota",1832,973,859,36532,1285,206,61,11,0,1832,70,11,81,211,112,99,775,28,NA
38067,"Pembina County, North Dakota",6853,3607,3246,39230,4956,838,155,47,45,6691,260,201,461,609,333,276,3169,38,NA
38069,"Pierce County, North Dakota",3999,1995,2004,35931,2855,574,223,12,30,3839,197,83,280,429,167,262,1831,3,NA
38071,"Ramsey County, North Dakota",11613,5770,5843,35624,7912,1499,317,172,27,11221,711,450,1161,1761,846,915,5889,21,NA
38073,"Ransom County, North Dakota",5663,2912,2751,36706,3927,622,169,29,12,5447,154,121,275,542,218,324,2688,10,NA
38075,"Renville County, North Dakota",2282,1205,1077,37370,1520,270,47,18,11,2179,63,32,95,142,66,76,1156,11,NA
38077,"Richland County, North Dakota",16548,8527,8021,38265,10689,2030,356,97,80,16374,555,416,971,1705,814,891,8341,110,NA
38079,"Rolette County, North Dakota",12292,6058,6234,23160,7156,789,307,27,39,12181,1674,1536,3210,2969,1426,1543,4429,31,NA
38081,"Sargent County, North Dakota",3828,2093,1735,42970,2755,388,107,4,9,3769,98,42,140,234,140,94,2051,11,NA
38083,"Sheridan County, North Dakota",1338,682,656,40365,1054,143,6,0,2,1336,68,19,87,92,34,58,624,4,NA
38085,"Sioux County, North Dakota",3896,1958,1938,17185,2058,180,50,5,1,3866,671,412,1083,1521,719,802,1037,8,NA
38087,"Slope County, North Dakota",837,466,371,40987,645,124,15,4,4,837,8,8,16,39,21,18,412,4,NA
38089,"Stark County, North Dakota",32989,17290,15699,40025,21339,4023,1105,132,123,32672,1531,1043,2574,3255,1630,1625,16528,129,NA
38091,"Steele County, North Dakota",1774,913,861,40435,1274,339,29,9,5,1774,61,32,93,231,117,114,832,3,NA
38093,"Stutsman County, North Dakota",21609,10985,10624,37288,15007,2706,773,82,112,20714,869,648,1517,2625,1231,1394,10640,126,NA
38095,"Towner County, North Dakota",2152,1141,1011,37116,1565,216,46,0,5,2122,141,61,202,288,104,184,1037,0,NA
38097,"Traill County, North Dakota",8004,4108,3896,40942,5433,1198,413,21,32,7766,257,159,416,495,257,238,4077,18,NA
38099,"Walsh County, North Dakota",10553,5425,5128,37344,7374,920,329,37,34,10306,470,298,768,1000,438,562,5127,5,NA
38101,"Ward County, North Dakota",69532,36443,33089,40896,44411,9023,2986,613,435,64839,2527,1419,3946,6127,2426,3701,37132,160,NA
38103,"Wells County, North Dakota",3990,1941,2049,41957,2869,527,74,10,8,3904,158,53,211,419,183,236,1840,10,NA
38105,"Williams County, North Dakota",39076,21134,17942,44076,24397,4410,1156,232,179,38772,2597,2197,4794,2865,1326,1539,19950,183,NA
39001,"Adams County, Ohio",27509,13776,13733,25428,18788,1514,1003,246,97,27253,1379,947,2326,5313,2623,2690,10284,43,NA
39003,"Allen County, Ohio",102087,51158,50929,31523,68467,8167,3649,748,544,99637,3407,2790,6197,12081,5395,6686,45300,481,NA
39005,"Ashland County, Ohio",52522,26094,26428,30303,35796,5103,2210,418,109,51959,2371,1865,4236,5950,2760,3190,24322,286,NA
39007,"Ashtabula County, Ohio",97666,49966,47700,29586,68664,7102,2875,523,265,94811,5586,3904,9490,17024,7999,9025,40922,405,NA
39009,"Athens County, Ohio",61276,30545,30731,27366,36121,5632,4907,443,1397,60628,2275,1341,3616,13049,6628,6421,27395,186,NA
39011,"Auglaize County, Ohio",46263,23184,23079,36849,31516,3973,2185,260,110,45738,1033,885,1918,3005,1194,1811,23580,179,NA
39013,"Belmont County, Ohio",66554,34600,31954,30563,48858,5451,2368,419,278,63062,2290,1824,4114,8800,4140,4660,28090,48,0
39015,"Brown County, Ohio",43715,21791,21924,31823,30495,2893,1348,122,72,43178,1585,1221,2806,6829,3037,3792,18800,174,NA
39017,"Butler County, Ohio",388327,191840,196487,37650,250309,51348,20831,3131,4549,384698,13805,10405,24210,44672,19958,24714,182553,877,NA
39019,"Carroll County, Ohio",26761,13653,13108,33798,19215,1623,862,61,39,26506,1579,1208,2787,3206,1370,1836,11572,152,NA
39021,"Champaign County, Ohio",38715,19337,19378,33377,27213,3345,1424,138,31,38282,1076,813,1889,3512,1563,1949,18144,118,NA
39023,"Clark County, Ohio",135877,66617,69260,31099,93613,10887,5351,689,529,134239,5408,3878,9286,20647,9469,11178,59345,229,0
39025,"Clermont County, Ohio",208851,103830,105021,41566,145158,27683,12541,2384,1225,207373,6848,4676,11524,17309,7139,10170,103116,394,0
39027,"Clinton County, Ohio",42077,21017,21060,32533,28281,3621,1840,144,223,41776,1214,1170,2384,5905,2535,3370,19725,167,NA
39029,"Columbiana County, Ohio",101723,51455,50268,30553,73589,8083,3357,310,379,98544,4051,3286,7337,12948,5480,7468,45689,256,NA
39031,"Coshocton County, Ohio",36629,18054,18575,27280,25230,2712,1286,66,100,36285,2046,1682,3728,6804,2858,3946,15264,257,NA
39033,"Crawford County, Ohio",41861,20711,21150,29566,29418,2754,1348,97,145,41362,1702,1083,2785,5759,2616,3143,18790,350,NA
39035,"Cuyahoga County, Ohio",1256620,604080,652540,39807,889511,180290,88888,28929,14785,1241944,40104,28796,68900,203273,90570,112703,592913,5024,0
39037,"Darke County, Ohio",51751,25940,25811,32732,35316,3844,1506,276,129,51183,1958,1590,3548,5641,2337,3304,24358,307,NA
39039,"Defiance County, Ohio",38300,19277,19023,33533,26294,3177,1477,268,53,37998,1606,1030,2636,3950,1712,2238,18548,140,NA
39041,"Delaware County, Ohio",216074,108175,107899,56963,143354,49877,23892,5018,3556,215217,5003,4362,9365,9668,4241,5427,112256,535,NA
39043,"Erie County, Ohio",75299,37056,38243,38158,54257,9429,3722,715,494,74179,2048,2022,4070,8501,3747,4754,35164,267,NA
39045,"Fairfield County, Ohio",159371,79759,79612,38783,107962,22057,9093,1574,841,156187,4966,4450,9416,13579,6053,7526,77254,643,NA
39047,"Fayette County, Ohio",28901,14270,14631,30666,19802,1702,863,93,62,28603,1158,1098,2256,4499,1759,2740,12678,27,NA
39049,"Franklin County, Ohio",1318149,648647,669502,41148,884031,226726,99691,25952,16165,1310166,61161,43840,105001,187488,86990,100498,682147,5290,0
39051,"Fulton County, Ohio",42602,21385,21217,35230,29212,3401,1565,231,142,42200,1484,913,2397,3577,1420,2157,20337,66,NA
39053,"Gallia County, Ohio",29276,14445,14831,28943,19986,2062,1209,197,164,28908,1502,1676,3178,4916,2478,2438,11616,72,NA
39055,"Geauga County, Ohio",95455,47836,47619,48582,66126,16495,6750,1723,1053,94652,3800,3898,7698,5518,2620,2898,47198,299,NA
39057,"Greene County, Ohio",167567,83333,84234,42862,113708,24036,17121,2894,2791,163872,4985,3463,8448,16929,8006,8923,80299,500,NA
39059,"Guernsey County, Ohio",38409,19218,19191,29642,26855,2603,1137,201,69,38032,2160,1513,3673,6448,2807,3641,16560,190,NA
39061,"Hamilton County, Ohio",827671,402336,425335,42555,560476,135727,62633,16506,11094,818958,27549,18649,46198,120457,52982,67475,408079,3867,0
39063,"Hancock County, Ohio",75072,37079,37993,37479,51383,9236,4384,513,509,74229,2321,1265,3586,7708,2729,4979,36806,267,NA
39065,"Hardin County, Ohio",30622,15312,15310,27566,18602,2148,992,160,138,30436,2053,1726,3779,5134,2064,3070,13593,147,NA
39067,"Harrison County, Ohio",14528,7186,7342,30163,10528,792,287,53,98,14229,929,910,1839,2194,908,1286,5605,78,NA
39069,"Henry County, Ohio",27601,13838,13763,36504,19085,2369,844,177,72,27215,876,582,1458,2581,1273,1308,13385,26,NA
39071,"Highland County, Ohio",43285,21303,21982,27971,29583,2916,1376,126,74,42808,2151,1747,3898,6342,2742,3600,18581,159,NA
39073,"Hocking County, Ohio",28104,14191,13913,29490,19886,2113,602,113,105,27827,1215,734,1949,4598,2234,2364,12424,114,NA
39075,"Holmes County, Ohio",44273,22311,21962,29238,26321,1941,764,141,65,43478,9007,9153,18160,3888,1636,2252,20276,242,NA
39077,"Huron County, Ohio",58518,29037,29481,30792,39929,4155,1333,413,302,58029,1968,2026,3994,6351,2626,3725,26975,227,NA
39079,"Jackson County, Ohio",32563,16059,16504,28570,22338,2415,952,109,71,32246,1287,1051,2338,5555,2530,3025,13433,110,NA
39081,"Jefferson County, Ohio",65280,32100,33180,30501,46261,5738,2575,297,411,64527,1758,1405,3163,11465,4924,6541,27544,120,NA
39083,"Knox County, Ohio",62657,30874,31783,32543,41172,6265,2643,429,425,61952,3303,3157,6460,7645,3342,4303,28192,430,NA
39085,"Lake County, Ohio",232236,114317,117919,41195,168448,33187,13858,2008,1359,230313,7371,4549,11920,17476,7199,10277,118513,606,NA
39087,"Lawrence County, Ohio",57994,28506,29488,29226,40878,4544,2159,467,251,57423,1650,1187,2837,10232,4707,5525,23216,204,NA
39089,"Licking County, Ohio",178844,88628,90216,39760,121399,24104,9676,1372,720,177479,5122,4244,9366,17152,7371,9781,85420,929,0
39091,"Logan County, Ohio",46098,23146,22952,36215,32033,3956,1793,142,149,45713,1408,931,2339,4981,2129,2852,20974,193,NA
39093,"Lorain County, Ohio",313101,155272,157829,37171,218104,37312,16968,2996,2088,307539,10193,7063,17256,41092,17117,23975,144410,1682,0
39095,"Lucas County, Ohio",430014,209528,220486,34399,291940,51164,22070,5004,3391,425269,14843,10059,24902,75081,33944,41137,195444,1082,NA
39097,"Madison County, Ohio",43961,24175,19786,33512,31763,4439,1569,388,81,39351,1693,992,2685,4009,1587,2422,19749,111,NA
39099,"Mahoning County, Ohio",227979,112026,115953,32591,162714,27175,11773,2673,966,223573,6798,4457,11255,39017,17467,21550,100983,1319,NA
39101,"Marion County, Ohio",65366,35088,30278,29257,46136,4186,1509,298,219,60236,1792,1555,3347,9641,4310,5331,26661,249,NA
39103,"Medina County, Ohio",182347,90831,91516,45038,128630,30285,12876,1851,1177,181064,4028,2651,6679,10758,4439,6319,94868,996,NA
39105,"Meigs County, Ohio",22242,11180,11062,26103,15814,1270,520,16,10,22039,1078,740,1818,4287,1975,2312,8159,25,NA
39107,"Mercer County, Ohio",42321,21467,20854,33892,28029,3839,1564,224,81,41848,1037,742,1779,2637,1245,1392,21473,84,NA
39109,"Miami County, Ohio",108818,54232,54586,37701,75367,11540,5896,804,352,107729,3070,2359,5429,9102,4039,5063,53983,261,NA
39111,"Monroe County, Ohio",13401,6826,6575,33127,9678,686,303,23,25,13282,609,333,942,1841,969,872,5318,80,NA
39113,"Montgomery County, Ohio",536121,259995,276126,35767,368011,65792,34430,5782,4289,527307,20209,15987,36196,78373,35286,43087,248049,1384,NA
39115,"Morgan County, Ohio",13851,6950,6901,25973,9961,735,312,46,21,13683,634,353,987,2264,970,1294,5347,28,NA
39117,"Morrow County, Ohio",35049,17821,17228,32987,24585,2890,1010,104,150,34741,1706,1755,3461,3659,1736,1923,17173,383,NA
39119,"Muskingum County, Ohio",86393,42320,44073,31436,59133,7036,3697,548,157,85555,2603,2629,5232,13133,5825,7308,38989,158,NA
39121,"Noble County, Ohio",14216,8413,5803,28676,10794,930,451,15,20,12047,390,590,980,2001,808,1193,4135,8,NA
39123,"Ottawa County, Ohio",40367,20275,20092,44479,30571,5257,2360,418,186,39901,1161,628,1789,3481,1357,2124,18665,417,NA
39125,"Paulding County, Ohio",18827,9403,9424,34050,13005,1410,534,27,33,18725,691,409,1100,1759,770,989,8367,21,NA
39127,"Perry County, Ohio",35451,17871,17580,29675,24430,2499,1020,86,11,35200,1531,1114,2645,5369,2503,2866,14819,115,NA
39129,"Pickaway County, Ohio",58809,31103,27706,32689,40969,5568,2069,214,186,54831,1853,1148,3001,6813,3186,3627,25292,150,NA
39131,"Pike County, Ohio",27151,13509,13642,29273,18624,1754,665,88,95,26929,796,672,1468,5297,2422,2875,10067,17,NA
39133,"Portage County, Ohio",161217,79722,81495,37771,106257,19883,10984,1347,1508,160179,5230,3555,8785,17374,7922,9452,80900,598,NA
39135,"Preble County, Ohio",40929,20382,20547,33627,28742,3334,1655,271,152,40670,1150,1032,2182,4191,1686,2505,19524,70,NA
39137,"Putnam County, Ohio",34400,17283,17117,36877,22965,4044,1571,246,91,34128,531,524,1055,2232,880,1352,17056,54,NA
39139,"Richland County, Ohio",125008,64024,60984,29570,87245,9600,4380,969,539,118699,4378,3610,7988,16356,7360,8996,53293,335,NA
39141,"Ross County, Ohio",76957,40257,36700,29718,54657,5498,2765,577,195,71790,2529,2208,4737,11548,4798,6750,30977,153,NA
39143,"Sandusky County, Ohio",58885,29370,29515,32788,41566,5219,2077,263,58,57973,1597,1568,3165,7498,3350,4148,27071,301,NA
39145,"Scioto County, Ohio",73716,36687,37029,25279,51355,5493,2893,326,307,71122,2435,1848,4283,16750,7432,9318,26345,102,NA
39147,"Seneca County, Ohio",55062,27744,27318,31770,37084,4528,1959,304,202,54204,1679,1255,2934,6063,2617,3446,26313,227,0
39149,"Shelby County, Ohio",48145,24454,23691,35363,31994,4261,1991,169,187,47762,1234,880,2114,5189,2478,2711,23620,73,NA
39151,"Stark County, Ohio",374199,183232,190967,34652,262027,40551,17480,3178,1907,369662,13589,8339,21928,48133,20802,27331,177007,2055,NA
39153,"Summit County, Ohio",539361,263300,276061,40786,381738,83276,35556,7608,5553,533747,17372,13043,30415,65839,28877,36962,264826,1883,0
39155,"Trumbull County, Ohio",201749,99158,102591,30294,144381,19107,7517,1467,812,198224,8037,5755,13792,33912,14193,19719,84556,717,NA
39157,"Tuscarawas County, Ohio",92840,46428,46412,31736,64183,8450,3518,436,222,91923,4515,3356,7871,11413,5253,6160,42276,432,NA
39159,"Union County, Ohio",63411,30672,32739,48025,43037,11101,4345,1018,458,60717,1561,1223,2784,3131,1302,1829,31865,303,NA
39161,"Van Wert County, Ohio",28833,14236,14597,31831,19896,2095,1127,113,88,28535,569,489,1058,2378,960,1418,13971,129,NA
39163,"Vinton County, Ohio",12790,6496,6294,27587,9053,966,332,24,76,12719,599,385,984,2419,1167,1252,5010,1,NA
39165,"Warren County, Ohio",243189,123412,119777,49360,164904,44054,22982,3354,3258,236180,4657,4055,8712,12120,5108,7012,120107,636,NA
39167,"Washington County, Ohio",59639,29683,29956,33987,42689,5482,2269,704,288,59029,2088,1892,3980,8198,3631,4567,26577,87,NA
39169,"Wayne County, Ohio",116680,58125,58555,32908,76670,11090,5545,890,902,115598,8286,7985,16271,9869,4394,5475,53961,754,NA
39171,"Williams County, Ohio",36973,18476,18497,31189,25795,2366,1123,67,161,36046,1291,663,1954,3996,1658,2338,17356,30,0
39173,"Wood County, Ohio",131564,65263,66301,39771,82400,18369,9084,1840,1613,130381,2899,2829,5728,16241,7052,9189,66642,230,NA
39175,"Wyandot County, Ohio",21818,10775,11043,33994,15341,2033,907,177,133,21555,372,395,767,1484,522,962,10849,37,NA
40001,"Adair County, Oklahoma",19726,9903,9823,20710,12785,846,479,40,23,19532,2476,2046,4522,4339,2014,2325,7067,114,NA
40003,"Alfalfa County, Oklahoma",5683,3547,2136,28976,4251,602,251,20,8,4546,270,201,471,534,253,281,2078,23,NA
40005,"Atoka County, Oklahoma",14117,7846,6271,25353,10044,983,448,24,29,12820,1461,1031,2492,2311,1128,1183,4937,55,NA
40007,"Beaver County, Oklahoma",5071,2549,2522,29533,3387,565,133,28,42,4978,398,401,799,351,112,239,2309,43,NA
40009,"Beckham County, Oklahoma",22295,12565,9730,26231,15297,1574,574,109,63,18913,1392,1192,2584,4110,1971,2139,8281,165,NA
40011,"Blaine County, Oklahoma",8661,4674,3987,30442,6123,842,187,34,27,7487,444,507,951,1013,379,634,3028,28,NA
40013,"Bryan County, Oklahoma",46528,22778,23750,29516,31086,4972,1867,310,250,45960,4704,4220,8924,7399,3364,4035,19983,119,NA
40015,"Caddo County, Oklahoma",26910,15120,11790,25559,18308,2030,639,43,45,25445,2849,1851,4700,4723,2163,2560,10624,252,NA
40017,"Canadian County, Oklahoma",156681,78044,78637,36884,103902,23238,7754,1300,997,154256,7565,7131,14696,12250,5601,6649,78324,500,NA
40019,"Carter County, Oklahoma",48202,23556,24646,31036,32134,3668,1906,407,313,47559,3936,3483,7419,7257,3140,4117,21047,339,0
40021,"Cherokee County, Oklahoma",47412,23129,24283,28178,30155,5472,2333,476,331,46940,4911,4442,9353,9468,4635,4833,20118,254,NA
40023,"Choctaw County, Oklahoma",14285,6910,7375,25283,9663,931,364,58,68,14106,1300,1058,2358,3195,1377,1818,5454,81,NA
40025,"Cimarron County, Oklahoma",2272,1151,1121,33925,1561,427,57,2,9,2253,188,231,419,246,101,145,1082,5,NA
40027,"Cleveland County, Oklahoma",295060,147722,147338,36913,188419,39435,18160,4076,4719,288241,15896,13045,28941,36252,16763,19489,147489,1422,NA
40029,"Coal County, Oklahoma",5287,2696,2591,26899,3580,374,185,11,47,5225,711,514,1225,1196,644,552,1959,28,NA
40031,"Comanche County, Oklahoma",121777,63246,58531,29980,78204,11724,4968,1197,702,107811,7468,6386,13854,18561,8909,9652,53915,615,NA
40033,"Cotton County, Oklahoma",5537,2713,2824,31989,3845,486,187,16,9,5420,394,182,576,1179,611,568,2353,63,NA
40035,"Craig County, Oklahoma",14144,7269,6875,24199,9923,837,403,67,23,13279,1147,1109,2256,2538,1264,1274,5246,43,NA
40037,"Creek County, Oklahoma",72076,35821,36255,31222,49331,6277,1882,437,275,71243,4603,3837,8440,9590,4105,5485,30846,157,NA
40039,"Custer County, Oklahoma",28391,13842,14549,30880,16660,3459,1196,138,380,27853,1520,1386,2906,4290,1881,2409,14054,61,NA
40041,"Delaware County, Oklahoma",40791,20200,20591,34489,29755,3822,1307,230,217,40403,3915,2752,6667,7647,3534,4113,15849,255,NA
40043,"Dewey County, Oklahoma",4504,2249,2255,31951,2865,369,170,12,9,4411,345,336,681,628,344,284,1836,41,NA
40045,"Ellis County, Oklahoma",3755,1827,1928,31331,2669,367,111,22,7,3697,312,225,537,541,243,298,1559,8,NA
40047,"Garfield County, Oklahoma",62456,31386,31070,32579,40653,6322,2433,255,213,60105,4615,4159,8774,8463,3739,4724,28409,136,NA
40049,"Garvin County, Oklahoma",25806,12882,12924,29270,17251,1833,809,122,64,25567,2262,2010,4272,3725,1644,2081,10699,56,NA
40051,"Grady County, Oklahoma",55314,27836,27478,34607,37546,6135,1660,362,149,54738,3520,3371,6891,5954,2855,3099,24743,246,NA
40053,"Grant County, Oklahoma",4152,2097,2055,33685,2800,446,142,15,23,4055,249,184,433,533,213,320,1798,36,NA
40055,"Greer County, Oklahoma",5531,3096,2435,22721,3955,304,66,0,2,4596,383,224,607,750,291,459,1926,2,NA
40057,"Harmon County, Oklahoma",2499,1243,1256,31814,1722,178,49,12,16,2417,263,184,447,425,173,252,1069,7,NA
40059,"Harper County, Oklahoma",3272,1613,1659,26279,2238,391,96,28,0,3216,187,183,370,443,217,226,1403,11,NA
40061,"Haskell County, Oklahoma",11651,5811,5840,25234,8001,825,256,48,44,11576,1194,911,2105,2467,1018,1449,4404,22,NA
40063,"Hughes County, Oklahoma",13409,7306,6103,22887,9361,847,434,46,40,11995,1311,963,2274,2484,1176,1308,4260,15,NA
40065,"Jackson County, Oklahoma",24776,12484,12292,31421,15827,2540,1061,115,121,23266,1745,1373,3118,3491,1636,1855,11658,147,NA
40067,"Jefferson County, Oklahoma",5420,2658,2762,30099,3647,490,104,15,0,5276,383,398,781,1221,506,715,2048,29,NA
40069,"Johnston County, Oklahoma",10410,5254,5156,24457,6859,1016,377,35,8,10323,876,798,1674,2275,1038,1237,3736,33,NA
40071,"Kay County, Oklahoma",43859,21922,21937,29800,29058,3666,1305,150,153,42987,3131,2436,5567,6998,3312,3686,18612,119,NA
40073,"Kingfisher County, Oklahoma",15290,7538,7752,35098,9880,1589,489,143,41,15075,1176,1081,2257,1838,756,1082,6850,15,NA
40075,"Kiowa County, Oklahoma",8446,4035,4411,23548,5801,767,222,26,21,8274,595,483,1078,1915,827,1088,3253,22,NA
40077,"Latimer County, Oklahoma",9537,4838,4699,25189,6531,575,201,35,26,9301,1004,864,1868,1522,642,880,3509,20,NA
40079,"Le Flore County, Oklahoma",48525,24544,23981,23718,32599,3350,1207,254,130,47149,5116,3858,8974,9567,4213,5354,18627,128,NA
40081,"Lincoln County, Oklahoma",33734,16937,16797,30408,23240,2627,912,89,71,33300,2307,1991,4298,4746,1990,2756,14320,232,NA
40083,"Logan County, Oklahoma",49919,24955,24964,39571,33348,7020,2242,724,267,49463,3489,2706,6195,6551,3321,3230,22183,102,NA
40085,"Love County, Oklahoma",10158,5137,5021,28560,6767,821,171,38,4,10068,805,729,1534,1430,674,756,4203,10,NA
40087,"McClain County, Oklahoma",42393,21349,21044,39921,28377,5141,1957,274,246,41978,2345,2100,4445,2987,1428,1559,20149,83,NA
40089,"McCurtain County, Oklahoma",31003,15366,15637,24635,20386,2324,713,99,64,30670,3188,3065,6253,6460,2985,3475,12201,213,NA
40091,"McIntosh County, Oklahoma",19159,9568,9591,24967,14058,1293,534,59,26,18874,2353,2156,4509,4154,1638,2516,6183,73,NA
40093,"Major County, Oklahoma",7678,3833,3845,33480,5223,690,231,32,5,7572,400,427,827,873,395,478,3387,28,NA
40095,"Marshall County, Oklahoma",15494,7918,7576,27997,10666,1240,343,68,18,15355,1590,1321,2911,2874,1472,1402,5890,51,NA
40097,"Mayes County, Oklahoma",39324,19757,19567,29607,26930,3088,763,175,109,38961,3131,3119,6250,6599,2767,3832,16439,178,NA
40099,"Murray County, Oklahoma",13837,7153,6684,32488,9532,1233,297,89,49,13358,880,815,1695,1949,881,1068,5893,19,NA
40101,"Muskogee County, Oklahoma",66606,32623,33983,26684,44319,6329,1943,274,389,63586,5211,4632,9843,11317,4771,6546,25734,359,NA
40103,"Noble County, Oklahoma",10981,5451,5530,31946,7489,1003,371,23,75,10825,402,500,902,1155,418,737,4712,25,NA
40105,"Nowata County, Oklahoma",9460,4678,4782,29851,6538,797,204,71,26,9338,750,799,1549,1480,638,842,3905,3,NA
40107,"Okfuskee County, Oklahoma",11349,6190,5159,23052,7858,647,295,26,15,10343,875,778,1653,2746,1371,1375,3780,81,NA
40109,"Oklahoma County, Oklahoma",795822,391854,403968,36987,519228,112085,44429,13996,7063,783298,58786,50623,109409,123243,54970,68273,381419,4552,0
40111,"Okmulgee County, Oklahoma",36900,18390,18510,27821,24684,2703,993,141,106,36212,3003,2555,5558,6359,2821,3538,14677,155,NA
40113,"Osage County, Oklahoma",46004,23249,22755,29906,32682,4458,1735,217,145,44446,2910,2655,5565,5548,2621,2927,18825,69,NA
40115,"Ottawa County, Oklahoma",30472,15060,15412,24354,19779,2027,715,215,96,30033,2756,2422,5178,5977,2664,3313,12105,77,NA
40117,"Pawnee County, Oklahoma",15682,7957,7725,28327,10787,1354,331,38,45,15498,1171,1036,2207,2319,1099,1220,6520,25,NA
40119,"Payne County, Oklahoma",82058,42359,39699,26916,44198,9371,4732,732,2223,80411,5559,4028,9587,17559,9009,8550,36655,294,NA
40121,"Pittsburg County, Oklahoma",43758,22282,21476,28257,30453,3849,1518,212,193,41775,3624,3120,6744,7869,3651,4218,16848,80,NA
40123,"Pontotoc County, Oklahoma",38116,18629,19487,30774,25124,4407,2176,255,392,37551,3763,2891,6654,4897,2282,2615,17006,215,NA
40125,"Pottawatomie County, Oklahoma",72734,34941,37793,28106,48236,6629,2752,420,275,70742,5073,4357,9430,10955,4903,6052,29303,240,NA
40127,"Pushmataha County, Oklahoma",10845,5312,5533,23393,7764,625,403,28,34,10725,1297,1029,2326,2314,1183,1131,3588,21,NA
40129,"Roger Mills County, Oklahoma",3423,1783,1640,43603,2362,334,145,19,28,3408,270,167,437,461,203,258,1469,31,NA
40131,"Rogers County, Oklahoma",95870,48039,47831,36885,65110,11363,3839,697,473,94747,5900,5258,11158,8980,3939,5041,45762,260,NA
40133,"Seminole County, Oklahoma",23592,11650,11942,23137,15607,1633,577,61,43,23149,2412,2334,4746,5160,2299,2861,8453,50,NA
40135,"Sequoyah County, Oklahoma",39538,19621,19917,24708,26856,2910,885,157,68,39018,3809,3526,7335,7632,3652,3980,15212,63,NA
40137,"Stephens County, Oklahoma",43140,21143,21997,31501,29904,3650,1672,172,153,42580,3330,2729,6059,7159,3058,4101,17283,140,NA
40139,"Texas County, Oklahoma",21144,11391,9753,23855,13009,2092,918,17,159,21038,2232,1627,3859,4234,2335,1899,10085,91,NA
40141,"Tillman County, Oklahoma",7013,3477,3536,23729,4686,574,224,5,48,6768,471,429,900,1146,512,634,2709,68,NA
40143,"Tulsa County, Oklahoma",668923,328785,340138,38496,439813,95513,34456,10527,5657,663141,49122,43232,92354,94860,41779,53081,318243,3670,NA
40145,"Wagoner County, Oklahoma",82269,41011,41258,35675,56279,10026,3459,787,425,81934,4913,4628,9541,7504,3276,4228,38272,595,NA
40147,"Washington County, Oklahoma",52579,25922,26657,34243,35690,7362,2550,474,583,52079,3468,2940,6408,7156,3175,3981,22900,238,NA
40149,"Washita County, Oklahoma",10930,5460,5470,31421,7460,903,483,49,26,10658,787,678,1465,1325,581,744,4710,185,NA
40151,"Woods County, Oklahoma",8661,4551,4110,29914,5369,1208,369,47,99,8151,420,367,787,1435,788,647,4044,0,NA
40153,"Woodward County, Oklahoma",20411,10797,9614,31995,13788,1836,604,132,87,19427,1398,1721,3119,2889,1085,1804,9248,134,NA
41001,"Baker County, Oregon",16685,8629,8056,32672,12415,2144,647,163,77,16260,521,483,1004,2225,1028,1197,6136,43,NA
41003,"Benton County, Oregon",95615,48293,47322,39940,58369,16602,8531,1907,4345,95391,3380,1697,5077,17101,8412,8689,45707,591,NA
41005,"Clackamas County, Oregon",420925,209373,211552,49340,300373,75770,28865,7791,5286,418915,12774,9246,22020,31670,13910,17760,202643,1910,0
41007,"Clatsop County, Oregon",41190,20435,20755,37166,30595,5030,2149,370,329,40652,1936,1465,3401,4176,2009,2167,18276,219,NA
41009,"Columbia County, Oregon",52865,26965,25900,37986,38085,4649,1774,302,272,52608,1472,1235,2707,4760,1942,2818,23814,152,NA
41011,"Coos County, Oregon",64908,32219,32689,33572,48945,6212,2868,639,348,64175,2779,1357,4136,10275,4439,5836,25253,524,NA
41013,"Crook County, Oregon",24987,12493,12494,38484,18626,2726,870,164,130,24917,874,986,1860,1965,917,1048,11025,68,NA
41015,"Curry County, Oregon",23404,11530,11874,38214,19116,2672,1453,173,234,23279,566,673,1239,2886,1336,1550,8625,49,NA
41017,"Deschutes County, Oregon",199352,99597,99755,46765,147063,36988,16216,4515,2233,198562,8465,5541,14006,18052,8160,9892,96606,858,0
41019,"Douglas County, Oregon",111322,55508,55814,31241,82360,10200,3883,867,613,110603,3427,3026,6453,16359,7979,8380,42065,320,NA
41021,"Gilliam County, Oregon",1983,1029,954,34042,1477,265,52,4,3,1952,64,52,116,251,99,152,777,1,NA
41023,"Grant County, Oregon",7237,3672,3565,33409,5609,738,282,54,8,7137,330,289,619,1164,470,694,2883,18,NA
41025,"Harney County, Oregon",7496,3792,3704,26910,5499,434,236,64,45,7395,256,327,583,890,528,362,3124,44,NA
41027,"Hood River County, Oregon",23965,11919,12046,43333,16735,3663,1676,820,248,23852,1382,818,2200,1558,724,834,12605,123,NA
41029,"Jackson County, Oregon",222604,109360,113244,36538,160008,29349,12772,4197,1676,221360,8244,5732,13976,29130,13112,16018,97138,677,NA
41031,"Jefferson County, Oregon",24659,12681,11978,30917,17060,2512,803,183,121,23640,1358,885,2243,2984,1474,1510,9917,61,NA
41033,"Josephine County, Oregon",87994,43101,44893,32159,65703,7812,3301,625,491,87313,4060,2680,6740,13981,6431,7550,32841,275,NA
41035,"Klamath County, Oregon",69506,34762,34744,31260,48771,6512,2709,469,474,68593,3248,2572,5820,12201,6167,6034,26823,112,NA
41037,"Lake County, Oregon",8201,4465,3736,29400,6130,794,321,22,77,7690,396,146,542,1505,726,779,3037,3,NA
41039,"Lane County, Oregon",382218,189292,192926,36776,264813,51671,24344,6019,5270,380220,14467,10439,24906,60298,27881,32417,178879,1689,NA
41041,"Lincoln County, Oregon",50334,24319,26015,35295,39183,6765,3253,767,538,49983,2475,1979,4454,7315,3189,4126,19621,133,NA
41043,"Linn County, Oregon",128598,64303,64295,32501,89890,12039,4626,1016,690,127738,5160,4260,9420,15074,7151,7923,56684,838,NA
41045,"Malheur County, Oregon",31538,17355,14183,22145,20497,2015,780,132,65,28226,1565,1348,2913,5276,2549,2727,11394,236,NA
41047,"Marion County, Oregon",345815,173623,172192,33545,230076,37530,14874,3116,2016,339300,17362,11996,29358,43663,20819,22844,155647,1387,0
41049,"Morrow County, Oregon",12140,6183,5957,29975,7712,547,258,57,9,12132,570,426,996,2020,1031,989,4900,74,NA
41051,"Multnomah County, Oregon",808098,403380,404718,49713,598188,171363,76500,23880,13679,802585,29693,20896,50589,96850,45879,50971,438555,4391,0
41053,"Polk County, Oregon",87600,43058,44542,38920,57222,10824,5079,900,947,86977,2504,2040,4544,10140,4524,5616,39897,347,NA
41055,"Sherman County, Oregon",1900,932,968,33206,1368,132,78,5,4,1900,46,22,68,295,107,188,789,22,NA
41057,"Tillamook County, Oregon",27345,13835,13510,35433,20699,3272,1234,291,131,26643,689,564,1253,3319,1704,1615,10750,276,NA
41059,"Umatilla County, Oregon",79904,41890,38014,30263,52883,6067,2827,521,235,76143,2583,2229,4812,8868,4164,4704,33310,207,NA
41061,"Union County, Oregon",26286,13176,13110,31640,17596,2916,803,243,232,26062,907,1003,1910,3925,1380,2545,11304,184,NA
41063,"Wallowa County, Oregon",7439,3673,3766,37378,5608,1126,492,138,37,7359,241,352,593,676,402,274,3284,86,NA
41065,"Wasco County, Oregon",26639,13645,12994,35869,18770,2493,989,344,312,26178,1275,999,2274,3049,1451,1598,11567,108,NA
41067,"Washington County, Oregon",599541,299671,299870,49553,417204,116615,52344,9813,12396,595457,17778,15219,32997,48495,21518,26977,312020,2580,0
41069,"Wheeler County, Oregon",1407,694,713,27847,1101,130,80,8,2,1407,20,29,49,137,77,60,484,1,NA
41071,"Yamhill County, Oregon",107674,54489,53185,38002,73347,13608,5062,1620,1171,105238,3746,2939,6685,11625,5503,6122,48875,682,NA
42001,"Adams County, Pennsylvania",104604,52094,52510,37349,73526,10195,5984,904,845,103502,3437,2750,6187,7909,3569,4340,50568,200,NA
42003,"Allegheny County, Pennsylvania",1245310,607557,637753,45939,902730,229538,114694,28571,22905,1233276,28566,19930,48496,134587,58879,75708,627652,5514,0
42005,"Armstrong County, Pennsylvania",65538,32862,32676,33390,48608,6171,2180,441,243,64960,1595,1099,2694,6725,3102,3623,29788,249,NA
42007,"Beaver County, Pennsylvania",167629,82169,85460,37649,123142,22588,8581,1036,753,166229,3778,2696,6474,17201,7410,9791,78748,779,NA
42009,"Bedford County, Pennsylvania",47613,23820,23793,31269,34889,3396,1851,261,108,47246,2069,1409,3478,5071,2241,2830,21872,146,NA
42011,"Berks County, Pennsylvania",428483,212820,215663,37776,292213,50120,21002,4091,3150,424226,15252,11674,26926,49115,22738,26377,206685,3687,0
42013,"Blair County, Pennsylvania",122640,60452,62188,33585,87416,13677,4917,1397,494,120928,3818,2772,6590,15739,7109,8630,56376,307,0
42015,"Bradford County, Pennsylvania",60159,30156,30003,32440,42551,5202,2471,541,306,59628,2221,1912,4133,7809,3524,4285,25435,156,NA
42017,"Bucks County, Pennsylvania",645163,319410,325753,54930,464065,119275,59754,12516,9424,639266,14627,11066,25693,35830,14844,20986,334130,2195,0
42019,"Butler County, Pennsylvania",194562,97055,97507,45389,139574,33619,15000,2593,2288,192593,3948,2548,6496,14930,6546,8384,94590,734,NA
42021,"Cambria County, Pennsylvania",133263,66411,66852,31532,95844,14836,4968,1158,767,130350,3055,1678,4733,18240,8042,10198,56653,636,NA
42023,"Cameron County, Pennsylvania",4536,2280,2256,27426,3476,302,68,8,0,4501,87,66,153,674,316,358,1777,0,NA
42025,"Carbon County, Pennsylvania",65018,32644,32374,34375,48059,5999,2108,257,446,64211,1832,1599,3431,7551,3258,4293,29552,164,NA
42027,"Centre County, Pennsylvania",158665,83943,74722,37262,97184,21837,13999,2131,6936,153728,5104,3646,8750,23717,13038,10679,73011,375,NA
42029,"Chester County, Pennsylvania",536474,266330,270144,60599,367451,120444,62297,12363,11104,531888,13674,11396,25070,31170,14391,16779,278038,3414,NA
42031,"Clarion County, Pennsylvania",37489,18539,18950,30444,25480,3634,1542,336,284,37064,1432,1091,2523,4942,1922,3020,17008,232,NA
42033,"Clearfield County, Pennsylvania",79707,42095,37612,29950,59485,7564,2892,646,275,75010,2231,1775,4006,10274,4960,5314,34235,342,NA
42035,"Clinton County, Pennsylvania",37860,18916,18944,30723,25001,3283,1361,164,267,37381,1955,1665,3620,4771,2183,2588,17268,111,NA
42037,"Columbia County, Pennsylvania",64924,31398,33526,31238,43527,6764,3230,475,615,64186,1686,925,2611,9313,4182,5131,29912,136,NA
42039,"Crawford County, Pennsylvania",83876,41371,42505,30989,58926,7559,3404,706,463,82191,3900,3410,7310,10204,4466,5738,35404,252,NA
42041,"Cumberland County, Pennsylvania",261269,130394,130875,43535,181984,43025,20208,4316,2816,254844,7828,5347,13175,19199,8783,10416,128792,914,0
42043,"Dauphin County, Pennsylvania",286108,139988,146120,39709,198441,42075,16598,5034,2334,282731,9273,6924,16197,34256,15020,19236,142055,1937,0
42045,"Delaware County, Pennsylvania",575312,279037,296275,46926,391672,91675,47495,11957,8961,568324,15685,12895,28580,53557,22343,31214,279844,2773,5
42047,"Elk County, Pennsylvania",30886,15773,15113,34222,22721,2889,1111,99,101,30571,499,340,839,2733,1244,1489,14790,128,NA
42049,"Erie County, Pennsylvania",270495,134616,135879,32858,186684,34409,15329,3017,2443,264539,6379,4552,10931,39662,17168,22494,122518,1303,NA
42051,"Fayette County, Pennsylvania",128417,64341,64076,31498,94625,11625,4827,635,556,125197,3237,2506,5743,20090,8562,11528,53239,689,NA
42053,"Forest County, Pennsylvania",6959,4582,2377,18857,5716,492,144,9,17,4597,214,92,306,881,480,401,1589,23,NA
42055,"Franklin County, Pennsylvania",156084,77293,78791,37520,110146,15426,7326,1319,1226,154914,8122,6511,14633,13857,6150,7707,74492,1009,NA
42057,"Fulton County, Pennsylvania",14545,7485,7060,33601,10579,1014,602,65,44,14522,444,337,781,1550,710,840,6793,70,NA
42059,"Greene County, Pennsylvania",35781,18713,17068,32272,25538,3478,1423,236,255,33667,874,697,1571,4208,1686,2522,13771,232,NA
42061,"Huntingdon County, Pennsylvania",44123,23607,20516,30392,31981,3819,1429,189,339,40519,1237,818,2055,4419,1884,2535,18037,220,NA
42063,"Indiana County, Pennsylvania",83394,41593,41801,30494,54397,8056,4486,728,983,82045,2880,2814,5694,10100,4375,5725,35567,270,NA
42065,"Jefferson County, Pennsylvania",44326,22308,22018,30280,31574,3514,1392,279,179,43762,1813,1561,3374,6133,2614,3519,19578,312,NA
42067,"Juniata County, Pennsylvania",23535,11805,11730,31251,16493,1582,602,124,57,23294,1748,1518,3266,2082,850,1232,10838,67,NA
42069,"Lackawanna County, Pennsylvania",215672,105900,109772,35296,151972,27715,13028,2873,1826,212051,5820,3960,9780,27010,11348,15662,100713,864,NA
42071,"Lancaster County, Pennsylvania",553202,272524,280678,39872,374869,73258,30874,5709,4562,547100,32121,28999,61120,44195,19046,25149,274411,2594,0
42073,"Lawrence County, Pennsylvania",85907,41879,44028,32319,61794,9710,3166,464,277,85001,2652,2214,4866,10322,4308,6014,38089,211,NA
42075,"Lebanon County, Pennsylvania",143258,70793,72465,35604,98487,14402,6244,1007,852,141239,6826,6106,12932,15214,6920,8294,68005,628,NA
42077,"Lehigh County, Pennsylvania",374110,184521,189589,39856,255117,50875,22231,5114,4319,369767,13252,10603,23855,43587,20388,23199,180104,2208,0
42079,"Luzerne County, Pennsylvania",325396,162277,163119,33535,231289,34996,15944,3117,2698,318566,11562,7288,18850,46812,20979,25833,150800,1808,0
42081,"Lycoming County, Pennsylvania",114022,56229,57793,32968,80154,12691,4912,988,942,110994,3374,2878,6252,13417,5799,7618,51688,226,NA
42083,"McKean County, Pennsylvania",40459,20929,19530,30278,28826,3454,1638,212,315,38687,836,784,1620,5343,2420,2923,17283,152,NA
42085,"Mercer County, Pennsylvania",110600,54917,55683,32081,78929,12182,5314,691,834,107106,3446,2569,6015,14013,5965,8048,47137,657,NA
42087,"Mifflin County, Pennsylvania",46146,22740,23406,28979,32350,2745,1158,130,225,45513,3399,2639,6038,7571,3317,4254,21056,175,NA
42089,"Monroe County, Pennsylvania",168128,84131,83997,36277,118803,19037,10370,1000,1143,167150,5565,5363,10928,18713,8211,10502,77614,732,NA
42091,"Montgomery County, Pennsylvania",856399,419933,436466,57945,603213,174882,93354,25376,16640,842975,18095,14025,32120,52365,22542,29823,443958,3358,0
42093,"Montour County, Pennsylvania",18165,8912,9253,43700,13288,2401,1230,811,395,17440,397,477,874,1510,589,921,8683,36,NA
42095,"Northampton County, Pennsylvania",314299,155709,158590,42643,220129,44339,20787,3744,3420,311265,7820,5073,12893,27768,12893,14875,153491,2296,0
42097,"Northumberland County, Pennsylvania",91340,46403,44937,31240,66933,8572,2879,631,279,87998,2357,1693,4050,10872,4701,6171,40657,291,NA
42099,"Perry County, Pennsylvania",45941,23368,22573,37018,33078,4113,1576,217,135,45493,2359,2129,4488,3712,1765,1947,22091,107,NA
42101,"Philadelphia County, Pennsylvania",1593208,757083,836125,35553,1090012,204967,107311,33039,20993,1580678,65443,50685,116128,351811,157006,194805,717569,11391,5
42103,"Pike County, Pennsylvania",58996,30212,28784,41139,44410,6914,4128,631,499,58672,1559,1483,3042,5854,2674,3180,25645,381,NA
42105,"Potter County, Pennsylvania",16390,8220,8170,29629,11947,1288,551,111,42,16169,587,514,1101,1975,881,1094,6670,65,NA
42107,"Schuylkill County, Pennsylvania",143201,73915,69286,32316,104476,12953,4961,875,505,136513,4382,3870,8252,16822,7836,8986,63364,508,NA
42109,"Snyder County, Pennsylvania",39797,19772,20025,31776,26578,3395,1665,258,266,39391,2399,2014,4413,3101,1454,1647,19142,114,NA
42111,"Somerset County, Pennsylvania",73802,38686,35116,31627,55224,6167,2487,528,333,69608,2448,1909,4357,7513,3436,4077,31886,260,NA
42113,"Sullivan County, Pennsylvania",5880,3096,2784,35618,4861,624,229,44,21,5701,203,83,286,689,377,312,2507,93,NA
42115,"Susquehanna County, Pennsylvania",38540,19522,19018,37532,28648,3627,1562,284,224,38255,1361,1096,2457,4254,1889,2365,16495,75,NA
42117,"Tioga County, Pennsylvania",41186,20676,20510,31131,29481,3871,1975,227,212,40848,1487,1073,2560,4926,2115,2811,18275,97,NA
42119,"Union County, Pennsylvania",42908,23217,19691,33566,29049,3850,2029,554,844,38236,2009,1838,3847,3731,1805,1926,16432,114,NA
42121,"Venango County, Pennsylvania",50475,25174,25301,31667,37461,4795,2085,232,151,49862,1433,1030,2463,6619,3111,3508,21359,141,NA
42123,"Warren County, Pennsylvania",38492,19478,19014,32319,28337,3514,1447,223,186,37946,1107,708,1815,4389,1952,2437,16977,192,NA
42125,"Washington County, Pennsylvania",209631,103708,105923,42859,151239,31275,13167,2731,1821,207713,4665,3201,7866,19392,8508,10884,100001,639,NA
42127,"Wayne County, Pennsylvania",51227,27289,23938,32207,39339,4811,2689,481,212,48220,1767,1376,3143,5272,2457,2815,20812,198,NA
42129,"Westmoreland County, Pennsylvania",354414,175081,179333,40193,263459,52112,23190,4306,2608,351260,7164,4188,11352,33778,14604,19174,169014,1015,NA
42131,"Wyoming County, Pennsylvania",26219,13254,12965,36533,18901,2618,1149,131,160,26016,663,346,1009,2850,1299,1551,11892,47,NA
42133,"York County, Pennsylvania",457051,227361,229690,38926,319732,53120,23817,4427,2850,452561,12644,9397,22041,38540,16921,21619,225878,1632,0
44001,"Bristol County, Rhode Island",50658,24571,26087,56739,35419,9708,5182,2005,1302,49983,681,360,1041,3394,1411,1983,25343,178,NA
44003,"Kent County, Rhode Island",170168,83198,86970,46564,126563,26052,12351,2677,1411,168881,3119,2185,5304,12655,5563,7092,88403,638,0
44005,"Newport County, Rhode Island",85442,42340,43102,58280,63786,19260,9853,2388,1738,82352,1943,1058,3001,6373,2777,3596,43577,512,NA
44007,"Providence County, Rhode Island",657984,323700,334284,38191,454952,86194,38775,9948,7009,647740,20080,14244,34324,85858,38629,47229,319802,4022,11
44009,"Washington County, Rhode Island",129998,63412,66586,50008,90564,24273,14650,2254,2795,128595,1575,1200,2775,9753,4008,5745,65562,439,NA
45001,"Abbeville County, South Carolina",24368,11865,12503,31443,17149,2311,623,167,168,24186,1269,1277,2546,3752,1613,2139,9815,102,NA
45003,"Aiken County, South Carolina",169865,82326,87539,34786,120157,22589,9736,1721,1522,167717,8591,6566,15157,23653,10548,13105,73609,213,NA
45005,"Allendale County, South Carolina",8073,4417,3656,19654,5670,349,198,64,0,7190,427,422,849,1955,894,1061,2606,33,NA
45007,"Anderson County, South Carolina",204592,99223,105369,33714,140512,23038,9625,2040,2024,202951,10792,10307,21099,28770,12645,16125,91484,670,NA
45009,"Bamberg County, South Carolina",13311,6418,6893,21991,8978,894,434,57,218,13124,787,1157,1944,2785,1316,1469,4756,72,NA
45011,"Barnwell County, South Carolina",20653,10283,10370,25640,13769,1250,577,86,61,20302,1588,754,2342,5116,2069,3047,8688,56,NA
45013,"Beaufort County, South Carolina",189071,93987,95084,48132,136528,34024,18203,4523,2486,181488,8563,7340,15903,19003,8181,10822,84685,732,NA
45015,"Berkeley County, South Carolina",231419,115726,115693,37563,154846,28413,12494,1698,1309,223375,12155,10654,22809,24818,10609,14209,113737,946,NA
45017,"Calhoun County, South Carolina",14145,6926,7219,30898,10500,1324,564,82,40,14011,810,492,1302,2594,1180,1414,6093,16,NA
45019,"Charleston County, South Carolina",409840,199049,210791,51480,295540,87624,36344,11709,6457,402825,20752,15294,36046,48952,20863,28089,210569,1780,NA
45021,"Cherokee County, South Carolina",56200,27445,28755,26706,38207,3885,2167,332,194,55713,3411,2690,6101,9921,3968,5953,23919,216,NA
45023,"Chester County, South Carolina",32171,15747,16424,26349,22441,1948,1023,77,61,31957,2321,1450,3771,6053,2506,3547,13438,236,NA
45025,"Chesterfield County, South Carolina",43536,21350,22186,26435,30442,2469,1127,237,85,43110,3048,2306,5354,8738,4033,4705,17675,763,NA
45027,"Clarendon County, South Carolina",31163,15383,15780,26290,22550,2423,1104,113,102,29871,1707,1314,3021,5827,2029,3798,10781,153,NA
45029,"Colleton County, South Carolina",38561,18675,19886,26253,26939,2764,1096,246,111,37886,3714,2270,5984,6259,2503,3756,15466,254,NA
45031,"Darlington County, South Carolina",63025,30142,32883,28821,43315,5138,2330,264,499,62310,2732,2788,5520,12494,5381,7113,25776,570,NA
45033,"Dillon County, South Carolina",28255,13381,14874,21736,18693,1306,797,66,51,27923,1941,2242,4183,8819,4028,4791,11149,96,NA
45035,"Dorchester County, South Carolina",162139,79482,82657,36543,109799,21108,9345,1189,679,159099,9219,7530,16749,19665,7952,11713,77259,774,NA
45037,"Edgefield County, South Carolina",26181,14104,12077,31232,19108,2260,1143,162,233,23983,1655,874,2529,4074,1936,2138,11020,39,NA
45039,"Fairfield County, South Carolina",20942,10240,10702,29269,15303,1386,650,119,97,20642,898,649,1547,3866,1585,2281,9136,124,NA
45041,"Florence County, South Carolina",137015,64679,72336,30733,92542,13742,6209,1170,900,135005,7324,6823,14147,23845,11470,12375,59787,454,NA
45043,"Georgetown County, South Carolina",63594,30536,33058,39403,48042,9331,3918,1068,567,63106,3567,2740,6307,10078,4654,5424,25553,120,NA
45045,"Greenville County, South Carolina",528251,257714,270537,40427,361179,89919,37549,8561,5905,523755,29407,24221,53628,56304,23735,32569,257265,4399,0
45047,"Greenwood County, South Carolina",69309,32530,36779,30237,46557,7245,3021,658,357,68065,3051,2597,5648,11498,5008,6490,28878,171,NA
45049,"Hampton County, South Carolina",18890,10180,8710,22727,13205,954,469,30,74,18072,1351,835,2186,3613,1601,2012,7180,30,NA
45051,"Horry County, South Carolina",356578,173106,183472,34147,266541,43751,17456,3680,2704,354948,27301,20983,48284,45882,20028,25854,152128,2326,NA
45053,"Jasper County, South Carolina",29444,14678,14766,31228,21362,3619,1020,224,110,28660,2175,1702,3877,5064,2185,2879,11940,25,NA
45055,"Kershaw County, South Carolina",65779,32239,33540,30310,45757,5882,3175,497,206,64958,2954,2670,5624,9446,4338,5108,28936,334,NA
45057,"Lancaster County, South Carolina",97611,47800,49811,39172,70340,13656,6299,742,459,95833,4154,3386,7540,11546,5104,6442,43090,829,NA
45059,"Laurens County, South Carolina",67456,33111,34345,27221,46889,5563,2183,359,296,66261,5238,3852,9090,12281,5436,6845,28596,210,NA
45061,"Lee County, South Carolina",16557,8455,8102,21054,11745,1070,561,24,42,15295,822,775,1597,4247,1896,2351,5504,102,NA
45063,"Lexington County, South Carolina",295934,144763,151171,37209,205290,42345,18676,2725,3189,293048,15497,11648,27145,33967,14256,19711,142954,1364,NA
45065,"McCormick County, South Carolina",9612,5187,4425,32017,7986,1164,454,47,33,8659,395,83,478,1435,659,776,3174,8,NA
45067,"Marion County, South Carolina",29212,13603,15609,21952,20292,1742,951,64,28,29041,2261,1705,3966,7925,3363,4562,10681,117,NA
45069,"Marlboro County, South Carolina",26585,13975,12610,20703,19034,1024,379,69,106,24242,1955,1354,3309,6733,3041,3692,8693,86,NA
45071,"Newberry County, South Carolina",37918,18569,19349,32251,25949,3469,1838,294,241,37472,2153,1339,3492,5699,2501,3198,16467,77,NA
45073,"Oconee County, South Carolina",78775,38804,39971,35315,57617,9502,5244,627,644,78152,4540,3711,8251,12239,5930,6309,31671,333,NA
45075,"Orangeburg County, South Carolina",84159,39563,44596,23636,56778,5784,3865,733,494,83349,5302,3136,8438,20224,9747,10477,31563,288,NA
45077,"Pickens County, South Carolina",131106,65776,65330,32059,82774,12364,6681,1120,2577,130247,6021,5498,11519,20880,10346,10534,58591,474,NA
45079,"Richland County, South Carolina",416161,200680,215481,35720,263144,61080,30257,7972,6576,394581,19825,15629,35454,65215,30424,34791,202979,3058,NA
45081,"Saluda County, South Carolina",18952,9903,9049,27912,13321,1473,826,184,73,18684,1693,1322,3015,3348,1885,1463,7725,375,NA
45083,"Spartanburg County, South Carolina",330119,161252,168867,32039,223505,34691,16947,2554,2214,325826,18448,16642,35090,46447,20592,25855,151753,1250,0
45085,"Sumter County, South Carolina",105199,51138,54061,28319,69519,9530,5562,456,492,99817,6258,4542,10800,16820,7237,9583,45080,442,NA
45087,"Union County, South Carolina",27158,12851,14307,26111,19408,1998,609,61,37,26764,1521,1563,3084,5624,2475,3149,10591,94,NA
45089,"Williamsburg County, South Carolina",30879,15038,15841,22946,22458,1977,1108,209,129,29402,1822,1515,3337,6901,3029,3872,11755,144,NA
45091,"York County, South Carolina",282987,137720,145267,41486,191641,44962,20760,3687,1216,281087,12795,10029,22824,23474,9573,13901,139955,1430,NA
46003,"Aurora County, South Dakota",2590,1359,1231,40299,1724,232,72,10,0,2492,111,61,172,128,58,70,1384,3,NA
46005,"Beadle County, South Dakota",19089,9456,9633,32177,12532,2077,739,172,206,18759,487,521,1008,1811,788,1023,9186,60,NA
46007,"Bennett County, South Dakota",3391,1597,1794,22068,1797,270,48,0,12,3348,443,424,867,991,447,544,1072,26,NA
46009,"Bon Homme County, South Dakota",7018,4227,2791,26450,5171,721,251,42,24,5374,189,135,324,630,335,295,2611,35,NA
46011,"Brookings County, South Dakota",34631,17743,16888,32778,18716,5202,1557,547,635,34410,1069,543,1612,3922,1864,2058,18827,65,NA
46013,"Brown County, South Dakota",38278,18974,19304,38035,25369,6111,1415,414,385,37701,1434,1169,2603,3923,1515,2408,20522,43,NA
46015,"Brule County, South Dakota",5247,2676,2571,34629,3576,694,172,43,11,5089,244,234,478,707,327,380,2608,41,NA
46017,"Buffalo County, South Dakota",1859,992,867,13731,911,47,5,0,10,1859,408,329,737,673,339,334,583,14,NA
46019,"Butte County, South Dakota",10369,5092,5277,34218,7263,924,325,48,23,10264,791,745,1536,841,326,515,4977,21,NA
46021,"Campbell County, South Dakota",1534,801,733,40617,1111,278,26,0,11,1534,37,32,69,86,37,49,761,14,NA
46023,"Charles Mix County, South Dakota",9302,4655,4647,27034,5655,1052,264,52,29,9024,799,807,1606,2049,995,1054,3780,15,NA
46025,"Clark County, South Dakota",3837,1957,1880,35573,2554,401,48,10,18,3769,155,133,288,351,157,194,1525,15,NA
46027,"Clay County, South Dakota",14953,7362,7591,30033,7334,1540,787,162,445,14685,474,685,1159,2670,1204,1466,7330,34,NA
46029,"Codington County, South Dakota",28402,14365,14037,36016,19341,2721,820,210,150,28007,956,1095,2051,3060,1175,1885,15203,48,NA
46031,"Corson County, South Dakota",3906,1974,1932,18757,2139,298,62,2,5,3906,466,332,798,1687,792,895,1156,16,NA
46033,"Custer County, South Dakota",8515,4241,4274,43745,6941,1248,681,120,68,8384,513,389,902,693,303,390,3786,31,NA
46035,"Davison County, South Dakota",19966,9894,10072,33282,13591,2509,488,95,69,19614,953,614,1567,2906,1448,1458,10274,104,NA
46037,"Day County, South Dakota",5485,2821,2664,34210,3909,652,176,41,7,5366,209,233,442,789,342,447,2449,11,NA
46039,"Deuel County, South Dakota",4298,2198,2100,35754,2941,567,98,25,7,4241,181,125,306,244,107,137,2085,31,NA
46041,"Dewey County, South Dakota",5275,2648,2627,20657,2792,346,138,11,4,5193,729,496,1225,1609,841,768,1927,29,NA
46043,"Douglas County, South Dakota",2823,1397,1426,37235,1894,323,57,5,5,2713,257,305,562,394,201,193,1433,21,NA
46045,"Edmunds County, South Dakota",4014,2092,1922,40159,2874,617,148,21,23,3911,119,74,193,282,152,130,1855,59,NA
46047,"Fall River County, South Dakota",7079,3599,3480,33745,5482,651,270,95,73,6841,498,541,1039,1315,622,693,2858,7,NA
46049,"Faulk County, South Dakota",2140,1034,1106,31533,1440,198,116,0,5,2073,54,34,88,494,189,305,947,16,NA
46051,"Grant County, South Dakota",7533,3867,3666,38787,5257,863,300,73,47,7434,362,306,668,724,371,353,3685,9,NA
46053,"Gregory County, South Dakota",3983,2063,1920,31505,2773,331,118,52,30,3914,178,105,283,503,285,218,1895,33,NA
46055,"Haakon County, South Dakota",1755,795,960,32270,1233,187,17,0,1,1715,108,74,182,183,58,125,798,21,NA
46057,"Hamlin County, South Dakota",6196,3225,2971,31643,3619,573,193,15,11,5993,316,248,564,445,252,193,2927,5,NA
46059,"Hand County, South Dakota",3075,1572,1503,40952,2123,427,79,27,5,3022,54,64,118,232,119,113,1609,3,NA
46061,"Hanson County, South Dakota",3443,1765,1678,33489,2121,336,96,12,4,3431,57,80,137,207,116,91,1839,15,NA
46063,"Harding County, South Dakota",1176,621,555,44603,863,202,16,7,11,1167,22,23,45,75,24,51,691,4,NA
46065,"Hughes County, South Dakota",17812,8860,8952,37645,12296,3053,694,387,221,16861,530,574,1104,1676,889,787,9176,25,NA
46067,"Hutchinson County, South Dakota",7401,3671,3730,35631,4982,962,225,71,25,7192,163,158,321,701,258,443,3649,61,NA
46069,"Hyde County, South Dakota",1319,683,636,36319,993,163,37,2,0,1278,31,36,67,85,46,39,727,12,NA
46071,"Jackson County, South Dakota",2838,1309,1529,15792,1712,196,46,6,19,2790,349,343,692,1058,444,614,817,0,NA
46073,"Jerauld County, South Dakota",1836,916,920,47964,1396,167,47,14,7,1790,56,41,97,163,51,112,961,2,NA
46075,"Jones County, South Dakota",1006,414,592,30962,670,173,49,3,2,1006,52,74,126,149,90,59,477,6,NA
46077,"Kingsbury County, South Dakota",5172,2661,2511,36484,3532,590,166,47,8,5073,193,93,286,470,207,263,2505,23,NA
46079,"Lake County, South Dakota",11207,5839,5368,44809,7737,1926,618,62,67,10994,268,169,437,1035,575,460,6017,62,NA
46081,"Lawrence County, South Dakota",26047,12840,13207,41086,18355,4574,1513,378,271,25820,1552,1233,2785,2794,1201,1593,14124,67,NA
46083,"Lincoln County, South Dakota",65801,32666,33135,46868,42903,12192,3859,1288,596,65468,1187,1550,2737,4201,1713,2488,36779,55,NA
46085,"Lyman County, South Dakota",3719,1966,1753,25997,2317,391,144,2,0,3696,424,338,762,919,436,483,1456,52,NA
46087,"McCook County, South Dakota",5714,2954,2760,34242,3712,730,242,40,16,5561,276,225,501,464,203,261,2927,16,NA
46089,"McPherson County, South Dakota",2251,1101,1150,41144,1663,273,58,0,10,2147,87,65,152,279,103,176,1072,19,NA
46091,"Marshall County, South Dakota",4363,2232,2131,44857,3029,608,68,5,25,4300,165,63,228,319,113,206,2184,15,NA
46093,"Meade County, South Dakota",29970,15706,14264,33857,20199,4198,926,265,142,28305,1670,1137,2807,2156,894,1262,15919,209,NA
46095,"Mellette County, South Dakota",1989,969,1020,16826,1248,115,29,5,0,1944,257,305,562,935,454,481,587,12,NA
46097,"Miner County, South Dakota",2312,1167,1145,32033,1661,224,36,3,11,2261,121,61,182,236,138,98,1111,41,NA
46099,"Minnehaha County, South Dakota",197742,100828,96914,39289,130706,31242,9808,2192,1431,194673,9387,6657,16044,16775,7909,8866,108862,602,0
46101,"Moody County, South Dakota",6346,3258,3088,35419,4236,732,297,96,19,6281,286,216,502,599,250,349,3013,22,NA
46102,"Oglala Lakota County, South Dakota",13695,6886,6809,10955,6994,402,159,0,9,13597,2984,2834,5818,7546,3814,3732,3123,285,NA
46103,"Pennington County, South Dakota",110386,56398,53988,38951,76300,16226,6242,1960,1040,107172,6541,5362,11903,13138,5559,7579,54623,471,NA
46105,"Perkins County, South Dakota",2970,1492,1478,40235,2101,320,76,13,16,2924,156,108,264,349,119,230,1569,3,NA
46107,"Potter County, South Dakota",2587,1264,1323,34335,1811,363,53,12,12,2509,98,79,177,174,126,48,1212,12,NA
46109,"Roberts County, South Dakota",10242,5276,4966,28613,6443,759,242,51,13,10044,907,974,1881,2085,998,1087,4243,83,NA
46111,"Sanborn County, South Dakota",2373,1188,1185,35468,1583,221,78,15,1,2310,92,72,164,201,81,120,1225,12,NA
46115,"Spink County, South Dakota",6355,3231,3124,37138,4513,916,166,35,14,6245,249,177,426,663,317,346,2939,16,NA
46117,"Stanley County, South Dakota",2979,1710,1269,46652,2130,362,170,30,10,2963,158,24,182,96,61,35,1714,0,NA
46119,"Sully County, South Dakota",1318,749,569,45475,1032,190,24,3,5,1318,91,22,113,111,48,63,777,9,NA
46121,"Todd County, South Dakota",9353,4616,4737,12562,4695,431,208,22,31,9216,1512,1031,2543,4794,2205,2589,2290,18,NA
46123,"Tripp County, South Dakota",5607,2859,2748,29463,4057,551,96,35,11,5467,407,187,594,1174,482,692,2599,1,NA
46125,"Turner County, South Dakota",8687,4335,4352,36103,5989,1195,265,76,48,8508,221,227,448,780,257,523,4411,26,NA
46127,"Union County, South Dakota",16700,8531,8169,47193,11461,2528,963,375,194,16522,495,353,848,1360,447,913,8435,94,NA
46129,"Walworth County, South Dakota",5317,2675,2642,35602,3768,743,205,35,59,5178,361,247,608,688,347,341,2516,33,NA
46135,"Yankton County, South Dakota",23311,12132,11179,37202,16238,2822,1170,284,154,21951,1066,630,1696,1730,663,1067,11674,97,NA
46137,"Ziebach County, South Dakota",2455,1227,1228,23657,1479,177,43,0,0,2455,459,318,777,1015,503,512,822,3,NA
47001,"Anderson County, Tennessee",77337,37953,39384,32803,55143,7440,4156,830,1100,76296,4433,3122,7555,11660,5157,6503,32457,181,NA
47003,"Bedford County, Tennessee",50533,25432,25101,28520,33792,4051,1209,347,178,50069,4046,2886,6932,6175,2668,3507,22971,220,NA
47005,"Benton County, Tennessee",15933,7837,8096,27185,11591,733,432,67,55,15783,801,842,1643,2835,1289,1546,5834,341,NA
47007,"Bledsoe County, Tennessee",14816,8744,6072,24241,11441,728,363,45,47,13643,1494,830,2324,3549,1792,1757,5497,0,NA
47009,"Blount County, Tennessee",135951,66732,69219,36376,98165,16230,6568,1756,990,134767,7593,5705,13298,11500,5067,6433,64637,454,NA
47011,"Bradley County, Tennessee",108859,53175,55684,31121,74607,11018,4769,1126,911,107833,6820,4938,11758,14128,6282,7846,49631,237,NA
47013,"Campbell County, Tennessee",39397,19508,19889,26791,28408,2147,1058,429,43,38750,2372,1572,3944,7473,3427,4046,14927,92,NA
47015,"Cannon County, Tennessee",14481,7312,7169,30234,10328,1210,364,59,174,14350,897,734,1631,2168,934,1234,6287,0,NA
47017,"Carroll County, Tennessee",28381,14053,14328,26818,19421,2302,1186,147,213,27902,2017,905,2922,4502,2104,2398,11616,496,NA
47019,"Carter County, Tennessee",56315,27645,28670,28321,42063,5687,2295,554,348,55382,4014,3143,7157,9896,4563,5333,22795,315,NA
47021,"Cheatham County, Tennessee",41184,20853,20331,35852,29340,4408,1645,306,358,40845,2374,1798,4172,3802,1316,2486,20410,297,NA
47023,"Chester County, Tennessee",17392,8384,9008,24788,11286,1130,541,56,119,17101,945,863,1808,2535,975,1560,6995,5,NA
47025,"Claiborne County, Tennessee",32092,15900,16192,25408,23056,2502,1257,490,75,31567,1779,1086,2865,5621,2663,2958,12619,34,NA
47027,"Clay County, Tennessee",7592,3630,3962,22931,5510,434,176,56,12,7480,309,309,618,1668,813,855,2592,79,NA
47029,"Cocke County, Tennessee",36186,17696,18490,25864,26270,2026,804,169,82,35846,2653,1926,4579,7158,3182,3976,14604,189,NA
47031,"Coffee County, Tennessee",58080,28682,29398,29277,39473,5443,2821,458,486,57502,3383,2174,5557,9700,4435,5265,25023,82,NA
47033,"Crockett County, Tennessee",13955,6853,7102,30362,9480,993,404,43,32,13726,1124,534,1658,2147,1032,1115,6377,18,NA
47035,"Cumberland County, Tennessee",61552,30166,31386,30952,47524,5206,2442,507,449,61030,3339,2228,5567,7697,3382,4315,22039,382,NA
47037,"Davidson County, Tennessee",709786,343836,365950,45951,495381,140915,56603,17238,13044,703608,47915,37459,85374,98696,41350,57346,390556,4104,0
47039,"Decatur County, Tennessee",11483,5661,5822,27578,8322,1048,160,25,68,11267,645,473,1118,2168,957,1211,4370,9,NA
47041,"DeKalb County, Tennessee",20209,10321,9888,27684,14386,2014,721,160,40,19973,1354,575,1929,3999,1887,2112,8153,36,NA
47043,"Dickson County, Tennessee",54563,26899,27664,33582,37919,4656,1969,470,229,54189,2681,2651,5332,5849,2500,3349,25497,405,NA
47045,"Dyer County, Tennessee",36818,17679,19139,37415,25019,3266,1422,410,312,36287,2086,1314,3400,5916,2566,3350,15817,160,NA
47047,"Fayette County, Tennessee",42228,21068,21160,40613,31529,5475,1834,410,376,41681,2022,1478,3500,4041,1854,2187,18894,331,NA
47049,"Fentress County, Tennessee",18642,9371,9271,24595,13453,1525,481,139,51,18471,1126,451,1577,3672,1827,1845,7127,26,NA
47051,"Franklin County, Tennessee",42980,21310,21670,31395,29560,3910,1905,360,270,42626,2098,1766,3864,5865,2567,3298,18881,74,NA
47053,"Gibson County, Tennessee",50455,24364,26091,27742,34441,3968,1780,281,356,49438,3025,2259,5284,6864,3213,3651,21155,194,NA
47055,"Giles County, Tennessee",30317,14682,15635,31852,21382,2632,1067,227,124,29920,1321,1096,2417,3970,1663,2307,12609,202,NA
47057,"Grainger County, Tennessee",23648,11960,11688,26545,17170,1377,778,90,175,23503,1495,1051,2546,4118,1796,2322,9411,58,NA
47059,"Greene County, Tennessee",70399,34731,35668,28237,50666,5678,2365,633,432,69304,3991,2985,6976,10651,4722,5929,28512,310,NA
47061,"Grundy County, Tennessee",13550,6749,6801,25075,9623,660,465,115,64,13379,949,878,1827,2422,1090,1332,5266,56,NA
47063,"Hamblen County, Tennessee",64531,31933,32598,27845,44329,5279,2147,563,362,63798,5053,3437,8490,10874,4983,5891,26689,304,NA
47065,"Hamilton County, Tennessee",367193,178248,188945,41198,259234,58187,24293,5635,4041,363510,19354,15679,35033,43857,20013,23844,179167,1241,0
47067,"Hancock County, Tennessee",6726,3312,3414,24120,4850,193,235,23,28,6580,413,363,776,2107,1074,1033,2101,6,NA
47069,"Hardeman County, Tennessee",25519,14142,11377,22098,18436,1296,461,78,97,22008,1432,860,2292,3515,1460,2055,8687,164,NA
47071,"Hardin County, Tennessee",26824,12878,13946,26068,19378,2129,725,154,54,26364,2078,1396,3474,5095,2008,3087,10426,89,NA
47073,"Hawkins County, Tennessee",57107,28159,28948,28648,41611,4684,1790,283,220,56487,3034,2459,5493,9511,3989,5522,21481,362,NA
47075,"Haywood County, Tennessee",17806,8445,9361,26031,12484,898,519,10,91,17602,1069,941,2010,3849,1581,2268,7153,280,NA
47077,"Henderson County, Tennessee",27845,13729,14116,25873,19260,1815,665,97,89,27451,1729,1536,3265,4923,2006,2917,11506,95,NA
47079,"Henry County, Tennessee",32305,15622,16683,28098,23375,2900,971,295,279,31846,1902,1586,3488,5731,2566,3165,12545,606,NA
47081,"Hickman County, Tennessee",24996,13117,11879,27764,17892,1583,486,128,29,23430,1130,993,2123,3329,1482,1847,10427,122,NA
47083,"Houston County, Tennessee",8253,4108,4145,27053,5809,414,184,31,34,8052,383,536,919,1066,473,593,3171,81,NA
47085,"Humphreys County, Tennessee",19032,9527,9505,29561,13339,1442,497,210,101,18733,1117,899,2016,2233,934,1299,7773,20,NA
47087,"Jackson County, Tennessee",11730,5944,5786,25534,8770,981,171,53,16,11552,582,538,1120,2266,894,1372,4704,31,NA
47089,"Jefferson County, Tennessee",55017,27186,27831,31947,39459,5119,2124,631,445,54179,2933,2148,5081,5920,2523,3397,24606,41,NA
47091,"Johnson County, Tennessee",17982,9804,8178,26627,13727,1333,544,95,79,16267,1210,935,2145,3465,1251,2214,6298,38,NA
47093,"Knox County, Tennessee",481406,235988,245418,39608,322573,77209,32478,9135,7466,477775,21080,16918,37998,58167,27195,30972,238588,1458,NA
47095,"Lake County, Tennessee",6898,4382,2516,19695,5264,339,204,10,17,4596,473,270,743,1281,582,699,1710,34,NA
47097,"Lauderdale County, Tennessee",25171,13008,12163,24358,17136,1089,586,92,21,22956,1404,1018,2422,4118,1785,2333,9045,208,NA
47099,"Lawrence County, Tennessee",44377,21913,22464,26865,29839,2807,1470,285,104,43865,3396,2677,6073,7021,3060,3961,18192,202,NA
47101,"Lewis County, Tennessee",12637,6251,6386,26873,8743,575,133,61,47,12482,881,707,1588,2339,1172,1167,5176,154,NA
47103,"Lincoln County, Tennessee",35365,17436,17929,32016,24770,2881,1453,299,152,34918,1941,1377,3318,4147,1921,2226,15839,76,NA
47105,"Loudon County, Tennessee",55507,27335,28172,40425,41137,7356,3602,281,425,55133,2459,2073,4532,6519,3126,3393,24262,90,NA
47107,"McMinn County, Tennessee",53532,26262,27270,30334,37686,4266,1502,542,250,52755,2929,2981,5910,7109,3195,3914,22261,58,NA
47109,"McNairy County, Tennessee",25895,12747,13148,25004,18281,1202,809,51,33,25523,1606,960,2566,4263,1796,2467,9710,35,NA
47111,"Macon County, Tennessee",25365,12408,12957,24979,16887,1091,357,190,29,25042,1520,1096,2616,4123,1769,2354,11481,197,NA
47113,"Madison County, Tennessee",98644,47371,51273,31380,66475,10415,4668,1243,913,97223,5949,4160,10109,17188,7907,9281,44068,1809,NA
47115,"Marion County, Tennessee",28852,14330,14522,29314,20693,1922,966,210,36,28637,1512,974,2486,4642,1995,2647,11826,81,NA
47117,"Marshall County, Tennessee",34567,17114,17453,32225,23527,3399,1145,282,85,34271,1332,1014,2346,5302,2493,2809,15692,78,NA
47119,"Maury County, Tennessee",102002,49972,52030,35733,70957,12487,4380,1010,468,100996,5269,3968,9237,8938,3717,5221,49963,253,NA
47121,"Meigs County, Tennessee",12839,6352,6487,26843,9322,680,276,79,37,12731,930,558,1488,1964,906,1058,4807,30,NA
47123,"Monroe County, Tennessee",46489,23143,23346,27356,33502,3581,1007,343,302,45949,2950,2164,5114,7235,3473,3762,17921,80,NA
47125,"Montgomery County, Tennessee",222305,111312,110993,31438,137996,26757,11880,1753,1502,208659,10637,7381,18018,25950,11504,14446,104222,1060,NA
47127,"Moore County, Tennessee",6558,3270,3288,35178,4787,731,159,90,129,6471,233,141,374,640,234,406,2865,12,NA
47129,"Morgan County, Tennessee",21124,11580,9544,27320,15303,1123,675,51,59,18869,1049,1032,2081,3897,1543,2354,7241,3,NA
47131,"Obion County, Tennessee",30670,14956,15714,28782,21643,2351,1136,127,114,30305,1332,1326,2658,4867,2114,2753,13120,251,NA
47133,"Overton County, Tennessee",22576,11305,11271,29556,15952,1427,591,93,105,22333,936,684,1620,3840,1627,2213,9977,61,NA
47135,"Perry County, Tennessee",8432,4197,4235,30870,5793,410,197,0,14,8273,618,741,1359,1172,433,739,3057,15,NA
47137,"Pickett County, Tennessee",5042,2510,2532,27259,3784,449,119,100,21,4965,256,162,418,1043,502,541,1692,44,NA
47139,"Polk County, Tennessee",17620,8836,8784,30400,12893,1062,418,126,111,17398,1440,1264,2704,2222,877,1345,7143,28,NA
47141,"Putnam County, Tennessee",80157,39887,40270,29419,51667,8994,3421,771,1061,79204,4296,2856,7152,12497,5994,6503,37665,120,NA
47143,"Rhea County, Tennessee",33031,16691,16340,26678,22843,2666,1028,89,124,32813,2362,1265,3627,5055,2214,2841,12560,54,NA
47145,"Roane County, Tennessee",53777,26388,27389,36579,39812,5161,2506,582,464,53190,2127,1790,3917,6466,2860,3606,23119,181,NA
47147,"Robertson County, Tennessee",73297,36439,36858,35093,50350,7875,2027,438,271,72491,3752,3084,6836,7470,3627,3843,35452,370,NA
47149,"Rutherford County, Tennessee",343727,169927,173800,35135,217950,50052,16870,2794,3049,341436,17084,14573,31657,33248,14768,18480,180732,1026,NA
47151,"Scott County, Tennessee",21917,10903,11014,22273,14918,920,445,80,84,21629,1454,1137,2591,5499,2439,3060,7780,94,NA
47153,"Sequatchie County, Tennessee",16065,8232,7833,25954,11627,1418,457,126,159,15828,1052,881,1933,3520,1755,1765,6249,131,NA
47155,"Sevier County, Tennessee",98455,48685,49770,31603,71045,9547,2916,1407,422,97489,7085,5768,12853,12864,5874,6990,45941,145,NA
47157,"Shelby County, Tennessee",926440,441579,484861,36230,610776,123239,59169,14812,9157,914546,60527,48540,109067,164861,70960,93901,422464,4238,0
47159,"Smith County, Tennessee",20034,10162,9872,31446,14009,1607,601,82,77,19864,1101,797,1898,2950,1392,1558,9064,270,NA
47161,"Stewart County, Tennessee",13724,6784,6940,28362,9715,1177,299,107,49,13580,867,618,1485,1547,692,855,5460,46,NA
47163,"Sullivan County, Tennessee",158722,77767,80955,33934,116111,20213,7019,1680,1638,156912,8245,6328,14573,23761,10660,13101,67689,1013,NA
47165,"Sumner County, Tennessee",196845,96687,100158,40419,135793,28742,10058,1951,1657,195221,8439,6960,15399,18315,8082,10233,98077,1078,NA
47167,"Tipton County, Tennessee",61116,30274,30842,31909,41274,5128,2299,440,239,60105,3294,2309,5603,6509,2429,4080,27667,295,NA
47169,"Trousdale County, Tennessee",11596,7204,4392,26522,8371,452,214,98,53,9208,466,333,799,1044,412,632,4880,0,NA
47171,"Unicoi County, Tennessee",17845,9004,8841,27930,13289,1538,537,152,63,17464,1035,517,1552,2880,1437,1443,7508,87,NA
47173,"Union County, Tennessee",19860,9880,9980,28174,14064,989,613,203,35,19689,1015,677,1692,3110,1324,1786,8124,44,NA
47175,"Van Buren County, Tennessee",6182,3113,3069,24099,4588,265,94,52,57,6077,541,469,1010,1012,467,545,2421,0,NA
47177,"Warren County, Tennessee",41163,20595,20568,27059,28286,2746,918,106,179,40680,3278,2235,5513,6818,3034,3784,17419,49,NA
47179,"Washington County, Tennessee",133282,65800,67482,35562,91259,17509,8347,2569,2028,131596,7283,5688,12971,20237,9145,11092,61983,805,NA
47181,"Wayne County, Tennessee",16325,9121,7204,26538,12219,1024,385,35,41,14473,988,849,1837,2837,1437,1400,6155,12,NA
47183,"Weakley County, Tennessee",32946,16288,16658,26820,21122,2657,1143,120,327,32489,2255,1506,3761,5796,2471,3325,14011,593,NA
47185,"White County, Tennessee",27420,13376,14044,26213,19417,1742,564,193,130,27076,1770,1717,3487,4605,1933,2672,11115,56,NA
47187,"Williamson County, Tennessee",248897,123066,125831,61451,163046,63976,26533,6388,4170,248272,5501,4837,10338,10337,4219,6118,125974,1277,NA
47189,"Wilson County, Tennessee",149096,73809,75287,42978,102516,25090,9858,1471,1245,147995,5766,4550,10316,12172,5215,6957,73588,745,NA
48001,"Anderson County, Texas",58077,35807,22270,23548,42436,3857,1284,203,220,45538,4138,3772,7910,7117,3518,3599,19753,246,NA
48003,"Andrews County, Texas",18362,9274,9088,39749,11043,1636,302,78,159,18230,2134,2399,4533,2177,1015,1162,9009,186,NA
48005,"Angelina County, Texas",86608,42586,44022,27460,56714,6706,3057,439,375,84625,7983,7750,15733,13536,6109,7427,36669,480,NA
48007,"Aransas County, Texas",24048,11986,12062,40890,19026,2992,1247,207,152,23759,1913,1758,3671,4241,1971,2270,8833,244,NA
48009,"Archer County, Texas",8649,4400,4249,37873,6034,1023,372,61,63,8598,772,651,1423,1054,531,523,4016,3,NA
48011,"Armstrong County, Texas",1912,879,1033,31823,1331,235,91,14,5,1848,63,71,134,109,70,39,815,5,NA
48013,"Atascosa County, Texas",49403,24580,24823,27386,31538,3483,827,227,44,48933,5740,4734,10474,6837,3160,3677,20318,474,NA
48015,"Austin County, Texas",30406,15298,15108,36399,20958,3753,1028,122,154,30148,2163,2054,4217,3593,1601,1992,14424,106,NA
48017,"Bailey County, Texas",6902,3287,3615,29674,4342,482,51,60,73,6718,1011,1143,2154,851,425,426,2813,399,NA
48019,"Bandera County, Texas",21182,10479,10703,39162,16279,2783,1189,301,177,21019,1787,1127,2914,2968,1482,1486,8952,127,NA
48021,"Bastrop County, Texas",98435,49988,48447,34079,64589,10118,3251,673,845,96113,9619,8815,18434,11454,5927,5527,44714,229,NA
48023,"Baylor County, Texas",3475,1738,1737,31392,2468,481,73,20,0,3396,265,289,554,395,170,225,1466,0,NA
48025,"Bee County, Texas",30977,19218,11759,22347,21600,1474,735,205,69,23761,2039,2055,4094,4703,1984,2719,9981,193,NA
48027,"Bell County, Texas",372821,186259,186562,31822,227732,40173,15235,3397,2165,349437,26505,24033,50538,52988,21995,30993,168459,1085,NA
48029,"Bexar County, Texas",2014059,1001527,1012532,33963,1297977,244258,107776,26476,16487,1977025,172183,144580,316763,299972,137515,162457,960800,11254,0
48031,"Blanco County, Texas",11608,5853,5755,46356,8849,2112,400,95,103,11501,1072,673,1745,1122,398,724,5329,61,NA
48033,"Borden County, Texas",686,301,385,39276,439,128,42,3,0,686,10,6,16,11,10,1,267,4,NA
48035,"Bosque County, Texas",18404,9135,9269,32990,13281,1793,496,113,117,18040,1749,1531,3280,2084,874,1210,7486,89,NA
48037,"Bowie County, Texas",92747,46884,45863,30103,62699,8817,3799,883,452,87122,6867,6609,13476,15117,6734,8383,37867,248,NA
48039,"Brazoria County, Texas",374600,190008,184592,39891,245242,49553,19724,4160,3591,362173,24789,23595,48384,27271,11516,15755,171722,1084,NA
48041,"Brazos County, Texas",234548,118812,115736,32499,123121,28990,13989,2550,7662,230202,14798,13224,28022,52720,25482,27238,112581,964,NA
48043,"Brewster County, Texas",9454,4578,4876,35516,7149,2039,1069,131,171,9376,646,467,1113,1445,606,839,4694,57,NA
48045,"Briscoe County, Texas",1290,710,580,29721,978,94,40,16,4,1290,152,118,270,311,185,126,496,21,NA
48047,"Brooks County, Texas",7059,3385,3674,20308,4914,691,241,0,7,6551,919,691,1610,2176,1078,1098,2951,0,NA
48049,"Brown County, Texas",38159,19020,19139,30202,26536,3901,1013,120,243,37013,3499,2889,6388,4822,2024,2798,16839,56,NA
48051,"Burleson County, Texas",17958,8767,9191,38918,12878,2102,606,111,74,17767,1372,1083,2455,2205,808,1397,7492,130,NA
48053,"Burnet County, Texas",49684,24537,25147,40628,35526,6892,2230,419,448,48893,4217,4294,8511,3806,1718,2088,22760,290,0
48055,"Caldwell County, Texas",46141,23228,22913,28742,30562,3641,1150,169,141,44025,6238,4538,10776,6144,3258,2886,20060,271,NA
48057,"Calhoun County, Texas",20127,10402,9725,33754,13619,1377,651,42,137,19864,1042,848,1890,1826,879,947,9608,0,NA
48059,"Callahan County, Texas",13869,6917,6952,31856,9723,1699,435,32,58,13766,1189,1184,2373,1203,512,691,6157,152,NA
48061,"Cameron County, Texas",421854,208182,213672,21440,250129,33806,10958,2557,1391,419997,59013,56496,115509,106182,48100,58082,166691,1677,NA
48063,"Camp County, Texas",12543,6007,6536,28004,8192,1203,382,62,51,12487,1433,1347,2780,2689,1062,1627,5171,58,NA
48065,"Carson County, Texas",5801,2890,2911,40192,3905,681,287,3,14,5758,387,204,591,432,135,297,2820,0,NA
48067,"Cass County, Texas",28637,13896,14741,28608,20037,2473,738,110,130,28276,1936,1927,3863,5220,2409,2811,10886,137,NA
48069,"Castro County, Texas",7381,3780,3601,25425,4499,669,169,6,33,7299,1019,698,1717,908,458,450,3364,0,NA
48071,"Chambers County, Texas",47037,24269,22768,42628,29931,4752,1498,327,244,46681,3729,3700,7429,6406,3126,3280,21825,45,NA
48073,"Cherokee County, Texas",50824,25996,24828,26790,33407,3423,1479,189,312,47680,5007,4927,9934,7847,3649,4198,19699,170,NA
48075,"Childress County, Texas",6781,4393,2388,27466,4993,526,111,81,13,5331,719,364,1083,802,491,311,2840,0,NA
48077,"Clay County, Texas",10290,5172,5118,35847,7534,1229,402,74,46,10184,887,718,1605,925,415,510,4745,12,NA
48079,"Cochran County, Texas",2529,1305,1224,23748,1689,103,37,4,0,2476,286,192,478,640,334,306,1036,8,NA
48081,"Coke County, Texas",3305,1645,1660,28397,2385,295,126,22,22,3206,187,220,407,524,222,302,1325,0,NA
48083,"Coleman County, Texas",7808,3913,3895,31249,5588,875,196,60,23,7770,1209,730,1939,1321,647,674,3361,5,NA
48085,"Collin County, Texas",1079153,537145,542008,52654,711181,240100,114983,18493,12523,1075700,57168,51185,108353,67718,30436,37282,559680,6739,6
48087,"Collingsworth County, Texas",2865,1405,1460,33436,1786,359,47,16,28,2794,367,479,846,623,284,339,1218,0,NA
48089,"Colorado County, Texas",20582,10233,10349,35002,14013,2208,562,217,120,20245,1858,1182,3040,1490,593,897,8769,74,NA
48091,"Comal County, Texas",165201,82455,82746,47280,115639,30280,12781,2330,1486,163795,9351,9025,18376,9998,4339,5659,76950,955,NA
48093,"Comanche County, Texas",13651,6881,6770,31171,9615,1214,515,41,45,13471,1253,1100,2353,1816,799,1017,6042,24,NA
48095,"Concho County, Texas",3235,1793,1442,24207,2474,216,60,1,9,2417,93,148,241,385,188,197,992,0,NA
48097,"Cooke County, Texas",41860,20838,21022,36275,28556,4462,1553,259,371,41392,3230,2967,6197,5479,2477,3002,19886,322,NA
48099,"Coryell County, Texas",82927,42084,40843,26699,52395,6302,2354,149,261,63231,4278,3581,7859,7092,3280,3812,33899,386,NA
48101,"Cottle County, Texas",1647,849,798,26081,1097,129,66,0,6,1647,61,112,173,397,172,225,713,0,NA
48103,"Crane County, Texas",4636,2293,2343,31973,2894,319,120,0,14,4514,537,457,994,172,98,74,2237,12,NA
48105,"Crockett County, Texas",2949,1575,1374,35942,2344,215,119,32,0,2888,345,179,524,269,187,82,1558,0,NA
48107,"Crosby County, Texas",5157,2607,2550,30888,3413,394,70,14,1,5067,519,493,1012,1192,481,711,2335,73,NA
48109,"Culberson County, Texas",2181,1343,838,29295,1688,164,2,11,0,2166,190,123,313,480,223,257,911,0,NA
48111,"Dallam County, Texas",7165,3836,3329,28936,4467,559,23,53,4,7128,875,931,1806,600,278,322,3814,0,NA
48113,"Dallas County, Texas",2604053,1294332,1309721,39172,1681632,353037,154247,41089,21416,2585512,296031,262490,558521,359882,158753,201129,1292835,13621,10
48115,"Dawson County, Texas",12342,6950,5392,22002,7853,902,100,33,25,10588,1253,850,2103,2624,1205,1419,4205,62,NA
48117,"Deaf Smith County, Texas",18585,9357,9228,23310,10827,952,224,29,76,18393,2096,2180,4276,2899,1269,1630,8286,288,NA
48119,"Delta County, Texas",5278,2406,2872,34345,3691,549,228,0,16,5215,180,185,365,736,281,455,2279,0,NA
48121,"Denton County, Texas",914870,453677,461193,50470,611044,193763,79113,11614,7994,911300,52100,47267,99367,66977,31119,35858,492599,5958,0
48123,"DeWitt County, Texas",19826,10433,9393,29359,13944,1409,416,133,3,17923,1540,1563,3103,2959,1266,1693,7490,112,NA
48125,"Dickens County, Texas",1570,739,831,28798,1174,159,52,18,8,1498,125,97,222,183,78,105,589,25,NA
48127,"Dimmit County, Texas",8672,4349,4323,19505,5327,429,281,47,20,8552,874,604,1478,3726,1768,1958,2352,19,NA
48129,"Donley County, Texas",3298,1666,1632,25682,2155,191,91,9,0,3203,256,295,551,334,118,216,1383,0,NA
48131,"Duval County, Texas",9960,5097,4863,21606,6380,284,210,5,0,9413,1058,848,1906,2017,754,1263,3590,96,NA
48133,"Eastland County, Texas",17812,8957,8855,31197,12158,1826,770,78,105,17551,1408,1435,2843,2738,1314,1424,7573,74,NA
48135,"Ector County, Texas",162300,83509,78791,34267,96948,10918,3984,772,422,161048,17486,17644,35130,25297,10547,14750,73281,834,NA
48137,"Edwards County, Texas",1380,769,611,25218,841,126,34,0,0,1346,184,164,348,315,188,127,716,0,NA
48139,"Ellis County, Texas",195509,97264,98245,38628,125963,24046,9210,1163,686,194202,16061,15291,31352,15850,7212,8638,97761,690,NA
48141,"El Paso County, Texas",863832,429824,434008,26011,535173,90357,32427,6589,4488,838774,92367,90894,183261,165778,72980,92798,377646,6923,0
48143,"Erath County, Texas",42788,21007,21781,32181,25212,5542,2026,293,298,42305,3262,3001,6263,6667,3583,3084,20446,206,NA
48145,"Falls County, Texas",17013,8065,8948,29183,11605,1027,373,54,110,15142,1479,1074,2553,2400,1487,913,6200,37,NA
48147,"Fannin County, Texas",36052,19230,16822,33481,25287,3356,1444,164,238,33165,2662,2514,5176,4237,2028,2209,14759,191,NA
48149,"Fayette County, Texas",24564,12244,12320,37849,18005,3179,881,190,82,24140,1543,1123,2666,2451,1115,1336,10737,21,NA
48151,"Fisher County, Texas",3680,1901,1779,32722,2608,353,136,22,8,3657,305,170,475,442,193,249,1793,8,NA
48153,"Floyd County, Texas",5386,2644,2742,28755,3488,429,106,22,2,5356,753,547,1300,1016,422,594,2187,18,NA
48155,"Foard County, Texas",1075,435,640,27262,698,81,26,0,5,1035,85,40,125,226,36,190,500,0,NA
48157,"Fort Bend County, Texas",832607,411621,420986,45172,536035,156424,76105,14460,13633,827611,48013,49937,97950,57188,25850,31338,393884,3431,5
48159,"Franklin County, Texas",10445,5452,4993,39246,7328,1459,617,49,126,10346,1027,544,1571,891,543,348,4489,22,NA
48161,"Freestone County, Texas",19599,10221,9378,28201,13871,1649,606,94,62,18187,1019,1046,2065,2300,1070,1230,7065,78,NA
48163,"Frio County, Texas",18151,11026,7125,22779,11719,607,227,34,130,14794,1063,1047,2110,3039,1261,1778,6830,126,NA
48165,"Gaines County, Texas",21523,10914,10609,28701,11665,955,256,2,0,21389,3218,3083,6301,2708,1149,1559,8472,325,NA
48167,"Galveston County, Texas",350801,173583,177218,42603,236769,53733,17606,4531,4172,346041,23806,23909,47715,37987,16722,21265,164431,1433,0
48169,"Garza County, Texas",5735,3485,2250,22188,4158,313,212,6,21,4356,364,347,711,663,368,295,1616,0,NA
48171,"Gillespie County, Texas",26953,13224,13729,42067,19720,4346,1949,282,371,26628,2580,2196,4776,2413,1066,1347,12087,47,NA
48173,"Glasscock County, Texas",1068,683,385,50449,739,217,45,17,0,1068,158,82,240,56,18,38,455,0,NA
48175,"Goliad County, Texas",7092,3522,3570,36114,5044,660,210,8,22,6995,408,373,781,698,265,433,2875,0,NA
48177,"Gonzales County, Texas",19736,10081,9655,32807,12754,1168,328,55,118,19447,1923,1755,3678,2540,1013,1527,8636,241,NA
48179,"Gray County, Texas",21272,11382,9890,30303,14061,1726,414,57,57,19653,1914,1911,3825,3316,1522,1794,8829,148,NA
48181,"Grayson County, Texas",137008,67315,69693,34643,92530,14097,5119,947,952,135810,11218,11324,22542,15361,6891,8470,63791,375,NA
48183,"Gregg County, Texas",124245,60840,63405,32236,80126,12208,4301,1053,405,121984,10512,10183,20695,19907,8111,11796,56334,273,NA
48185,"Grimes County, Texas",29442,15894,13548,28792,20175,2418,1158,229,114,26037,2407,2325,4732,3719,1625,2094,11335,114,0
48187,"Guadalupe County, Texas",173828,86706,87122,37184,115577,22664,9354,1151,972,171006,10567,9174,19741,14956,7070,7886,83268,682,NA
48189,"Hale County, Texas",32525,16851,15674,23696,19888,1827,884,98,135,30567,3485,3333,6818,5596,2108,3488,13458,77,NA
48191,"Hall County, Texas",2847,1371,1476,26847,1978,277,69,8,6,2795,306,286,592,519,192,327,1155,4,NA
48193,"Hamilton County, Texas",8244,4103,4141,36764,5812,1040,307,95,14,8038,602,613,1215,1377,666,711,3312,9,NA
48195,"Hansford County, Texas",5270,2780,2490,27585,3276,812,140,9,8,5191,546,339,885,434,172,262,2429,32,NA
48197,"Hardeman County, Texas",3541,1837,1704,29783,2473,326,78,24,3,3532,335,191,526,390,162,228,1802,3,NA
48199,"Hardin County, Texas",56576,27727,28849,33700,38319,5413,1399,153,112,56088,4203,5062,9265,7506,3498,4008,23503,152,NA
48201,"Harris County, Texas",4726177,2359415,2366762,38184,3032681,629798,258583,72382,45086,4700447,532520,464767,997287,737681,327635,410046,2239156,41980,0
48203,"Harrison County, Texas",69098,33790,35308,30613,45553,6889,2581,320,322,68373,5777,5351,11128,10946,4768,6178,30667,221,NA
48205,"Hartley County, Texas",5369,3055,2314,27850,4062,591,295,23,118,3903,313,525,838,270,91,179,1695,0,NA
48207,"Haskell County, Texas",5408,2878,2530,37600,3963,472,322,2,3,5140,439,607,1046,773,376,397,2265,0,NA
48209,"Hays County, Texas",245351,122589,122762,38909,149815,39393,15849,2291,2937,243400,16956,14474,31430,30750,13095,17655,124248,1633,0
48211,"Hemphill County, Texas",3371,1911,1460,40940,2262,410,109,8,0,3322,363,242,605,204,114,90,1546,34,NA
48213,"Henderson County, Texas",82627,40851,41776,32513,58449,7663,2790,421,261,81648,7627,7667,15294,11986,5909,6077,33007,298,NA
48215,"Hidalgo County, Texas",873167,431639,441528,20844,496398,69445,23007,4473,2965,865514,132514,135531,268045,239276,110036,129240,332795,12341,NA
48217,"Hill County, Texas",36138,18161,17977,30730,24820,2974,1153,186,33,35478,3327,3023,6350,4681,1925,2756,15366,135,NA
48219,"Hockley County, Texas",21495,10775,10720,28809,13638,1544,638,85,77,21279,2129,2136,4265,3129,1315,1814,9554,65,NA
48221,"Hood County, Texas",62459,30357,32102,41729,45404,9707,3508,558,598,61674,4813,4084,8897,5467,2547,2920,26263,205,NA
48223,"Hopkins County, Texas",37008,18359,18649,32100,24949,3704,1294,227,163,36455,3701,3149,6850,4874,2349,2525,16779,87,NA
48225,"Houston County, Texas",22107,12021,10086,25346,16318,1719,543,108,41,19198,1645,1482,3127,3374,1647,1727,7676,6,NA
48227,"Howard County, Texas",34488,19633,14855,32431,23829,2233,668,172,219,30826,2985,2127,5112,4428,1994,2434,14167,99,NA
48229,"Hudspeth County, Texas",3329,2027,1302,16368,2242,212,20,0,0,2437,415,292,707,620,359,261,966,4,NA
48231,"Hunt County, Texas",101596,50144,51452,31362,67094,9796,3379,592,545,100768,8056,8419,16475,12082,5380,6702,44966,450,0
48233,"Hutchinson County, Texas",20595,10552,10043,30038,13527,1537,495,49,30,20472,1743,1457,3200,2114,920,1194,8999,12,NA
48235,"Irion County, Texas",1561,748,813,29664,1127,183,13,11,0,1552,194,151,345,116,51,65,689,0,NA
48237,"Jack County, Texas",8588,4774,3814,28626,5841,678,177,30,23,7559,722,687,1409,1096,485,611,3060,13,NA
48239,"Jackson County, Texas",15010,7470,7540,29684,10059,1060,232,0,19,14789,1103,1163,2266,1770,894,876,5890,19,0
48241,"Jasper County, Texas",33032,16240,16792,31251,22805,1927,769,20,75,32002,3158,3282,6440,7291,3080,4211,12091,91,NA
48243,"Jeff Davis County, Texas",1992,1106,886,38603,1634,204,169,8,74,1951,206,129,335,480,363,117,700,23,NA
48245,"Jefferson County, Texas",254942,131138,123804,30770,170001,23546,7482,1749,1065,241246,25952,24159,50111,43498,18731,24767,103041,890,NA
48247,"Jim Hogg County, Texas",4830,2515,2315,18366,2439,209,82,12,8,4786,873,426,1299,1364,669,695,2042,16,NA
48249,"Jim Wells County, Texas",39060,19461,19599,25030,24864,2994,680,69,52,38687,4146,3688,7834,8731,3593,5138,14790,130,NA
48251,"Johnson County, Texas",182690,92223,90467,32728,119361,17706,6349,827,640,180046,15628,14013,29641,19045,8489,10556,85387,363,0
48253,"Jones County, Texas",19758,12581,7177,21173,14653,1284,262,47,42,13592,1057,1563,2620,1924,874,1050,6338,21,NA
48255,"Karnes County, Texas",14805,8705,6100,25910,10347,1184,400,95,5,11310,781,1061,1842,2355,872,1483,4804,4,NA
48257,"Kaufman County, Texas",149773,74364,75409,33250,94837,16082,5355,338,766,148637,9868,10290,20158,14486,5883,8603,71908,486,NA
48259,"Kendall County, Texas",45376,22351,23025,56063,31578,9746,4230,828,515,44831,2645,2738,5383,2280,936,1344,21045,294,NA
48261,"Kenedy County, Texas",116,69,47,21822,87,5,2,0,0,116,11,10,21,3,2,1,46,0,NA
48263,"Kent County, Texas",635,323,312,29575,452,64,61,0,1,578,13,11,24,46,30,16,187,7,NA
48265,"Kerr County, Texas",52810,25725,27085,38003,38482,7081,3034,638,704,51837,4667,4716,9383,6395,3124,3271,22844,206,NA
48267,"Kimble County, Texas",4316,2161,2155,39045,3177,602,242,19,22,4281,382,384,766,528,230,298,2089,0,NA
48269,"King County, Texas",216,113,103,26408,160,41,4,0,4,216,22,1,23,60,33,27,85,0,NA
48271,"Kinney County, Texas",3157,1947,1210,29833,2536,174,148,15,0,2938,198,202,400,459,266,193,1314,0,NA
48273,"Kleberg County, Texas",30860,15582,15278,25876,17217,2560,1106,156,131,30234,2886,2354,5240,8885,3864,5021,13086,174,NA
48275,"Knox County, Texas",3333,1629,1704,24892,2310,195,114,5,13,3203,249,268,517,366,184,182,1394,9,NA
48277,"Lamar County, Texas",50149,24449,25700,29888,34191,4736,1829,361,217,49645,4474,4981,9455,7892,3486,4406,22572,356,NA
48279,"Lamb County, Texas",13024,6523,6501,26687,8225,804,224,12,19,12820,1608,1643,3251,2233,839,1394,5456,146,NA
48281,"Lampasas County, Texas",21829,11019,10810,33787,15447,2183,800,93,42,21466,1633,1296,2929,2052,802,1250,8762,179,NA
48283,"La Salle County, Texas",6965,4303,2662,15492,4483,144,92,7,0,6004,677,506,1183,1683,884,799,2207,78,NA
48285,"Lavaca County, Texas",20379,10068,10311,34591,14057,1940,712,86,11,19937,1153,942,2095,2035,982,1053,9147,68,NA
48287,"Lee County, Texas",17543,8665,8878,31001,12387,1456,501,58,40,17152,1278,1085,2363,2258,1076,1182,7672,417,NA
48289,"Leon County, Texas",15928,7918,8010,34519,11219,1180,473,24,7,15856,1450,1494,2944,2277,1015,1262,6183,53,NA
48291,"Liberty County, Texas",93523,46504,47019,25667,58795,4551,1480,121,57,87380,10045,11372,21417,15410,7499,7911,32970,404,NA
48293,"Limestone County, Texas",22222,11315,10907,26479,15524,1865,586,65,101,21498,2340,1775,4115,4600,2257,2343,8100,23,NA
48295,"Lipscomb County, Texas",3038,1386,1652,33236,1872,378,58,19,8,2988,251,344,595,409,134,275,1344,5,NA
48297,"Live Oak County, Texas",11374,6118,5256,27951,8273,630,354,50,88,9921,867,922,1789,2081,760,1321,4000,67,NA
48299,"Llano County, Texas",21637,10332,11305,48116,17083,3794,969,526,145,21430,1478,1698,3176,2420,940,1480,8055,80,NA
48301,"Loving County, Texas",96,51,45,44821,63,0,0,0,0,96,0,0,0,5,0,5,39,0,NA
48303,"Lubbock County, Texas",311509,154200,157309,33700,184975,36968,15447,3476,4455,307126,21986,19495,41481,51472,24328,27144,151356,1008,NA
48305,"Lynn County, Texas",5619,2912,2707,31000,3668,630,232,23,16,5565,577,351,928,1041,471,570,2461,3,NA
48307,"McCulloch County, Texas",7638,3917,3721,29514,5385,685,308,4,2,7511,846,574,1420,1005,424,581,3189,51,NA
48309,"McLennan County, Texas",261090,128169,132921,31036,159035,26129,11640,2760,2317,256998,18577,17778,36355,44851,20208,24643,117951,838,NA
48311,"McMullen County, Texas",670,296,374,27029,432,51,17,0,0,670,21,127,148,100,47,53,247,6,NA
48313,"Madison County, Texas",13556,7679,5877,24340,9295,947,248,62,48,11366,742,774,1516,1403,643,760,4698,78,NA
48315,"Marion County, Texas",9668,4724,4944,27263,7233,977,178,6,15,9565,659,451,1110,1502,650,852,3364,93,NA
48317,"Martin County, Texas",5228,2833,2395,36881,3019,294,140,72,4,5170,446,312,758,873,386,487,2176,12,NA
48319,"Mason County, Texas",3959,1977,1982,36235,2769,722,219,66,45,3950,228,213,441,195,90,105,1629,19,NA
48321,"Matagorda County, Texas",36251,18259,17992,29001,23788,3322,1408,154,76,35834,3321,2879,6200,7798,3457,4341,14742,98,NA
48323,"Maverick County, Texas",57806,28883,28923,21405,33187,3846,1016,351,38,57520,7394,8749,16143,13473,5684,7789,22296,324,NA
48325,"Medina County, Texas",51432,26705,24727,31516,34739,4622,2668,253,163,49122,3757,2997,6754,5045,2398,2647,21776,298,NA
48327,"Menard County, Texas",1964,986,978,31983,1525,228,82,20,34,1917,284,203,487,431,124,307,671,4,NA
48329,"Midland County, Texas",169393,86602,82791,46914,105464,21716,7509,1201,630,167933,12890,12964,25854,18020,8288,9732,85072,983,0
48331,"Milam County, Texas",25080,12359,12721,31984,17084,2148,731,147,90,24560,2278,1702,3980,3505,1543,1962,10580,155,NA
48333,"Mills County, Texas",4501,2279,2222,37010,3395,629,240,37,60,4339,308,279,587,297,128,169,2012,17,NA
48335,"Mitchell County, Texas",8947,5054,3893,24591,5459,392,111,12,9,7455,706,1218,1924,1042,305,737,3745,8,NA
48337,"Montague County, Texas",20197,9818,10379,31125,14199,1823,365,145,41,19901,1494,1606,3100,2573,1204,1369,8196,57,NA
48339,"Montgomery County, Texas",629989,314216,315773,48161,412475,102960,38603,7601,6514,627117,47309,42381,89690,55202,24242,30960,297162,2514,0
48341,"Moore County, Texas",21284,11073,10211,26321,12547,994,420,23,49,21137,2333,2181,4514,2839,1334,1505,9653,145,NA
48343,"Morris County, Texas",11993,5675,6318,26199,8137,640,389,12,61,11839,786,812,1598,1844,691,1153,4953,110,NA
48345,"Motley County, Texas",1223,639,584,29788,921,140,41,7,0,1223,139,88,227,115,54,61,562,2,NA
48347,"Nacogdoches County, Texas",64768,31302,33466,27584,37715,6015,2411,519,619,63964,4753,5165,9918,13339,5117,8222,27800,577,NA
48349,"Navarro County, Texas",52834,26564,26270,26910,33975,3882,1472,238,185,52024,5204,4205,9409,8502,3822,4680,22195,80,NA
48351,"Newton County, Texas",12333,6175,6158,23995,8735,424,134,4,31,12181,1651,1315,2966,2944,1439,1505,4221,14,NA
48353,"Nolan County, Texas",14657,7429,7228,30572,9530,872,353,69,36,14480,1024,1446,2470,2230,800,1430,6187,108,NA
48355,"Nueces County, Texas",353245,176105,177140,32284,231734,33323,13296,3141,2358,347381,33740,29137,62877,59784,26520,33264,160375,1424,NA
48357,"Ochiltree County, Texas",9924,4994,4930,30836,6078,747,271,41,69,9850,1072,1263,2335,1200,437,763,4804,164,NA
48359,"Oldham County, Texas",2171,1284,887,27710,1302,224,58,7,22,1852,145,82,227,318,133,185,874,0,NA
48361,"Orange County, Texas",84761,42264,42497,35301,56679,7267,1928,252,281,84069,7167,6535,13702,9995,4354,5641,37696,297,NA
48363,"Palo Pinto County, Texas",28569,14050,14519,31890,19471,2326,1007,132,52,28299,2771,2522,5293,4473,1946,2527,11985,249,NA
48365,"Panola County, Texas",22540,11276,11264,32024,15292,1796,503,73,98,22289,2474,1968,4442,3078,1284,1794,9529,37,NA
48367,"Parker County, Texas",151188,75827,75361,43434,102048,20626,8508,1709,670,149659,10899,9769,20668,11791,4835,6956,71963,592,NA
48369,"Parmer County, Texas",9809,5140,4669,28342,6233,856,249,37,8,9717,1232,1115,2347,924,399,525,4677,61,NA
48371,"Pecos County, Texas",15114,8469,6645,28217,10286,714,225,207,34,12863,1073,1135,2208,2926,1498,1428,5976,26,NA
48373,"Polk County, Texas",50536,27262,23274,27922,36530,3197,1203,258,159,46887,4005,3810,7815,7654,3193,4461,17662,306,NA
48375,"Potter County, Texas",117905,60843,57062,26406,75078,8904,2676,748,411,111263,13059,10812,23871,23029,10748,12281,49483,539,NA
48377,"Presidio County, Texas",6168,3029,3139,22256,3794,568,188,49,0,6167,1117,919,2036,2465,1074,1391,2449,74,NA
48379,"Rains County, Texas",12257,6127,6130,36069,9191,1341,500,41,2,12193,956,1030,1986,1338,455,883,5019,118,NA
48381,"Randall County, Texas",141489,70037,71452,40047,93239,20217,7431,1293,1557,140575,6764,6690,13454,13072,5068,8004,72342,876,NA
48383,"Reagan County, Texas",3308,1697,1611,28765,1986,144,89,0,5,3284,154,405,559,236,121,115,1566,15,NA
48385,"Real County, Texas",2830,1324,1506,22725,1967,316,81,0,15,2728,191,349,540,636,307,329,744,0,NA
48387,"Red River County, Texas",11627,5656,5971,25057,8469,786,313,42,42,11437,993,1172,2165,2310,972,1338,4303,79,NA
48389,"Reeves County, Texas",14022,8530,5492,26180,9135,712,172,15,0,12898,1520,632,2152,2704,1690,1014,6255,69,NA
48391,"Refugio County, Texas",6718,3179,3539,27103,4703,384,130,13,0,6562,512,525,1037,1068,284,784,2557,5,0
48393,"Roberts County, Texas",764,422,342,32250,536,76,22,0,5,764,42,58,100,112,59,53,398,17,NA
48395,"Robertson County, Texas",16912,8398,8514,30568,11556,1458,560,55,51,16724,1132,1111,2243,2380,1170,1210,6617,126,NA
48397,"Rockwall County, Texas",110631,55091,55540,53000,72042,20110,8111,1782,1601,109869,4602,4979,9581,4575,1874,2701,56151,560,0
48399,"Runnels County, Texas",9858,4976,4882,29784,6840,889,317,40,7,9647,830,657,1487,1136,420,716,4404,4,NA
48401,"Rusk County, Texas",52755,28432,24323,30365,36101,3771,1720,74,151,47941,3853,3736,7589,6416,2802,3614,21072,264,NA
48403,"Sabine County, Texas",9980,4989,4991,33953,7611,724,510,103,24,9874,606,697,1303,1705,886,819,3029,45,NA
48405,"San Augustine County, Texas",7920,3828,4092,24673,5847,437,222,57,31,7693,912,753,1665,2093,1045,1048,2585,63,NA
48407,"San Jacinto County, Texas",27666,13794,13872,28124,19564,1746,817,227,340,27478,2861,2622,5483,4780,2084,2696,10378,252,NA
48409,"San Patricio County, Texas",68942,35185,33757,30692,44640,5325,2153,214,166,68177,5878,5629,11507,10701,4596,6105,28393,164,NA
48411,"San Saba County, Texas",5779,3086,2693,26377,4116,577,196,18,9,5183,667,509,1176,736,393,343,2312,9,NA
48413,"Schleicher County, Texas",2474,1181,1293,28084,1655,163,42,20,0,2436,267,336,603,357,146,211,1058,16,NA
48415,"Scurry County, Texas",16883,9084,7799,28549,11030,1492,388,123,44,15325,1534,1390,2924,1757,905,852,6876,67,NA
48417,"Shackelford County, Texas",3134,1583,1551,32245,2148,565,102,13,16,3098,178,261,439,350,133,217,1483,37,NA
48419,"Shelby County, Texas",24157,12094,12063,26642,15896,1587,496,115,1,23997,2649,2236,4885,5575,2699,2876,10047,235,NA
48421,"Sherman County, Texas",2414,1188,1226,43340,1579,264,80,0,0,2380,165,201,366,198,89,109,1116,1,NA
48423,"Smith County, Texas",234667,113874,120793,33903,154691,28037,9856,2491,1968,231934,20374,19468,39842,28799,13645,15154,107599,1420,NA
48425,"Somervell County, Texas",9337,4573,4764,39037,6560,1400,356,100,20,9160,530,631,1161,667,347,320,4543,263,NA
48427,"Starr County, Texas",65716,32196,33520,16934,36496,3343,1046,126,132,65191,10882,10675,21557,21796,9254,12542,23333,293,NA
48429,"Stephens County, Texas",9260,4997,4263,28231,6350,884,261,7,17,8814,886,655,1541,1467,525,942,3815,100,NA
48431,"Sterling County, Texas",1392,737,655,31039,820,120,36,29,7,1356,193,113,306,24,14,10,575,0,NA
48433,"Stonewall County, Texas",1331,681,650,26733,769,57,59,0,0,1289,117,117,234,91,43,48,664,11,NA
48435,"Sutton County, Texas",3345,1651,1694,22836,1975,157,142,4,0,3326,281,259,540,551,228,323,1421,0,NA
48437,"Swisher County, Texas",6989,3848,3141,21371,4529,712,139,23,0,6366,542,758,1300,1879,861,1018,2610,5,NA
48439,"Tarrant County, Texas",2113854,1041366,1072488,39407,1365169,305663,120073,22291,14908,2095938,183992,170618,354610,229643,100666,128977,1050372,10150,8
48441,"Taylor County, Texas",143029,70009,73020,31492,87176,16025,6685,1427,857,136403,10932,10238,21170,19947,8544,11403,70258,392,NA
48443,"Terrell County, Texas",862,501,361,36144,718,143,69,0,0,862,69,18,87,55,0,55,364,0,NA
48445,"Terry County, Texas",11816,6456,5360,25206,7356,595,151,65,0,11030,1368,1039,2407,2464,1028,1436,4957,12,NA
48447,"Throckmorton County, Texas",1439,773,666,30381,1064,161,50,0,4,1439,238,143,381,201,51,150,717,45,NA
48449,"Titus County, Texas",31301,15601,15700,25058,19428,2095,712,115,60,31069,3271,2881,6152,5674,2373,3301,13191,254,NA
48451,"Tom Green County, Texas",119276,59736,59540,33861,77310,12655,4821,868,708,114432,8042,7746,15788,13332,5442,7890,57290,512,NA
48453,"Travis County, Texas",1289054,658063,630991,54870,901585,301552,131365,30328,21723,1280605,87875,71630,159505,142451,67126,75325,725645,6397,6
48455,"Trinity County, Texas",13735,6786,6949,30911,9979,1130,272,79,0,13582,1242,1114,2356,1925,907,1018,4849,32,NA
48457,"Tyler County, Texas",19962,10828,9134,29594,14458,1256,536,55,48,17832,1348,1491,2839,3184,1411,1773,6255,180,NA
48459,"Upshur County, Texas",41261,20514,20747,30236,28275,3463,1100,199,52,40751,3244,3450,6694,5900,2746,3154,16377,57,NA
48461,"Upton County, Texas",3284,1640,1644,27385,2195,148,64,0,0,3221,192,187,379,655,318,337,1320,0,NA
48463,"Uvalde County, Texas",24833,12409,12424,26141,15486,2200,550,92,114,24300,2415,2275,4690,5791,2995,2796,9661,120,NA
48465,"Val Verde County, Texas",47693,24643,23050,25181,28847,3516,1727,423,171,44601,4696,4512,9208,7418,3532,3886,21131,325,NA
48467,"Van Zandt County, Texas",60053,29603,30450,33092,41750,5096,1693,189,152,59443,4944,5583,10527,7760,3329,4431,24887,237,NA
48469,"Victoria County, Texas",91209,44940,46269,31747,59744,8322,2117,544,486,90126,7370,7398,14768,14870,6471,8399,41154,267,NA
48471,"Walker County, Texas",77182,45638,31544,23220,51244,6420,2583,340,558,64399,5068,4614,9682,11841,4798,7043,28340,322,NA
48473,"Waller County, Texas",57463,28521,28942,32446,31707,5807,1691,336,53,57244,6046,4425,10471,6890,3175,3715,24146,157,NA
48475,"Ward County, Texas",11347,5732,5615,30854,7184,621,172,20,2,11236,813,532,1345,1530,705,825,5042,6,NA
48477,"Washington County, Texas",35807,17609,18198,39147,24195,4631,1376,608,366,34843,2645,2028,4673,3988,1973,2015,16369,471,NA
48479,"Webb County, Texas",267282,132495,134787,23446,150530,22081,6872,1500,531,265442,36887,38550,75437,56471,25147,31324,110657,2018,NA
48481,"Wharton County, Texas",41614,20761,20853,29061,27211,3508,1146,191,82,41234,3797,4018,7815,5998,2552,3446,17908,260,NA
48483,"Wheeler County, Texas",4980,2580,2400,30454,3452,502,86,3,5,4898,542,549,1091,896,371,525,2269,78,NA
48485,"Wichita County, Texas",129584,67086,62498,30834,83476,12624,5506,935,858,117358,9240,7970,17210,18483,7823,10660,62261,728,NA
48487,"Wilbarger County, Texas",12795,6305,6490,24291,8703,1101,203,108,36,12352,927,483,1410,2244,1239,1005,5436,69,NA
48489,"Willacy County, Texas",20308,11047,9261,20229,12926,994,301,32,28,19063,3131,2267,5398,5032,2590,2442,7939,49,NA
48491,"Williamson County, Texas",617396,307076,310320,47574,414552,123988,52779,8114,6991,614086,30373,29485,59858,38840,17296,21544,321072,3637,NA
48493,"Wilson County, Texas",50381,25470,24911,40952,34277,6216,2117,222,149,49733,3212,2876,6088,5112,2314,2798,23328,122,NA
48495,"Winkler County, Texas",7582,3925,3657,32325,4675,350,67,0,8,7496,702,702,1404,947,431,516,3380,55,NA
48497,"Wise County, Texas",70062,35479,34583,36614,47242,7054,2029,373,373,69195,5488,5726,11214,6230,2597,3633,33718,234,NA
48499,"Wood County, Texas",45341,22754,22587,34541,32972,4216,1945,543,264,44285,3709,2982,6691,5497,2296,3201,16925,137,NA
48501,"Yoakum County, Texas",7630,3576,4054,34168,4596,394,12,39,0,7606,743,764,1507,1036,553,483,3273,58,NA
48503,"Young County, Texas",17903,8822,9081,35039,12426,2002,625,155,19,17634,1709,1624,3333,2767,1105,1662,8135,74,NA
48505,"Zapata County, Texas",13896,6953,6943,19139,7912,722,128,27,21,13776,1865,1842,3707,5109,2386,2723,4669,25,NA
48507,"Zavala County, Texas",9700,5101,4599,20409,5822,588,163,40,10,9615,626,543,1169,2987,1427,1560,3612,13,NA
49001,"Beaver County, Utah",7102,3814,3288,28176,4241,924,192,20,32,6897,525,295,820,485,260,225,3023,9,NA
49003,"Box Elder County, Utah",58291,29874,28417,30762,34857,6499,2046,240,221,57914,2399,2309,4708,4719,2147,2572,26707,234,NA
49005,"Cache County, Utah",134428,67593,66835,29298,68799,17456,7168,1096,1768,133655,4783,3933,8716,17695,8169,9526,66302,302,0
49007,"Carbon County, Utah",20338,10219,10119,26450,13286,1563,504,94,62,20110,743,666,1409,3317,1512,1805,8067,46,NA
49009,"Daggett County, Utah",638,366,272,27261,429,53,16,2,7,577,25,11,36,46,26,20,256,2,NA
49011,"Davis County, Utah",363032,184446,178586,39218,215372,54957,21481,3754,2456,358634,11563,9657,21220,21786,8997,12789,178241,752,NA
49013,"Duchesne County, Utah",19779,10004,9775,28650,11720,1152,441,45,47,19495,1467,1302,2769,2625,1253,1372,7930,71,NA
49015,"Emery County, Utah",9898,5036,4862,27771,6282,572,369,38,1,9819,428,336,764,1156,494,662,3955,34,NA
49017,"Garfield County, Utah",5121,2635,2486,29240,3747,785,268,56,27,4947,441,275,716,787,502,285,2321,58,NA
49019,"Grand County, Utah",9680,4947,4733,37510,6970,1501,401,281,28,9609,752,425,1177,1505,658,847,5480,0,NA
49021,"Iron County, Utah",58068,29210,28858,26650,32559,6623,2222,518,528,57724,3145,2602,5747,8109,3681,4428,26664,250,NA
49023,"Juab County, Utah",11943,6287,5656,31545,6736,989,327,88,37,11823,466,423,889,1009,429,580,5412,0,NA
49025,"Kane County, Utah",7814,3897,3917,36941,5607,1238,406,84,88,7609,346,245,591,978,481,497,3422,0,NA
49027,"Millard County, Utah",13027,6703,6324,27757,7915,1428,328,18,90,12878,785,641,1426,1439,681,758,5230,53,NA
49029,"Morgan County, Utah",12367,6417,5950,40485,6940,1667,722,103,116,12357,313,299,612,213,110,103,5292,116,NA
49031,"Piute County, Utah",1764,940,824,19919,1234,171,58,0,13,1746,204,69,273,365,206,159,570,5,NA
49033,"Rich County, Utah",2543,1287,1256,26796,1528,250,118,27,15,2535,105,95,200,203,49,154,976,24,NA
49035,"Salt Lake County, Utah",1180643,597700,582943,40969,754424,182997,71199,17745,12429,1173416,63348,52866,116214,94306,43940,50366,619466,4223,7
49037,"San Juan County, Utah",14524,7293,7231,25591,8909,1153,437,76,32,14309,1473,1245,2718,2937,1437,1500,5156,39,NA
49039,"Sanpete County, Utah",28816,15325,13491,25257,17341,2294,1180,148,249,26755,1318,1569,2887,3888,1641,2247,12036,26,NA
49041,"Sevier County, Utah",21667,11144,10523,28859,13611,2083,818,114,92,21374,1023,976,1999,2501,1046,1455,9170,52,NA
49043,"Summit County, Utah",42524,21971,20553,67602,28806,10326,4340,1218,663,42395,1618,1316,2934,2218,1075,1143,22696,425,NA
49045,"Tooele County, Utah",74032,37722,36310,34733,43518,6423,2523,279,603,73555,2909,2612,5521,3322,1486,1836,36512,139,NA
49047,"Uintah County, Utah",35951,18211,17740,27977,21267,2856,767,114,86,35664,2573,2353,4926,4105,1858,2247,14316,134,NA
49049,"Utah County, Utah",666021,338404,327617,33251,335378,99898,32451,5585,5696,663054,27845,23932,51777,57565,26567,30998,320495,1932,0
49051,"Wasatch County, Utah",35009,17880,17129,51178,21373,6585,2240,624,527,34809,1551,1008,2559,1864,938,926,16948,229,0
49053,"Washington County, Utah",183297,91287,92010,36047,120527,24819,10020,2575,2076,181758,11305,10874,22179,15967,7188,8779,77459,654,NA
49055,"Wayne County, Utah",2532,1299,1233,32605,1753,269,87,9,25,2505,111,157,268,212,98,114,1271,6,NA
49057,"Weber County, Utah",262960,133298,129662,34778,164790,31010,10422,1619,1461,259875,12236,9892,22128,19866,9291,10575,131828,1080,0
50001,"Addison County, Vermont",37434,18716,18718,42271,26081,6343,3080,613,877,37165,1131,617,1748,2577,1211,1366,19341,161,NA
50003,"Bennington County, Vermont",37326,18243,19083,39717,26835,5734,3662,738,439,36766,959,738,1697,4059,1761,2298,17461,178,NA
50005,"Caledonia County, Vermont",30418,15313,15105,36604,21985,4219,1989,413,306,30167,924,448,1372,3500,1586,1914,15234,360,NA
50007,"Chittenden County, Vermont",168309,83053,85256,47458,112289,36064,18247,4296,3933,166911,3352,2225,5577,17754,7807,9947,93578,525,0
50009,"Essex County, Vermont",5976,3024,2952,31891,4562,515,298,45,62,5974,206,112,318,789,305,484,2566,10,NA
50011,"Franklin County, Vermont",50101,25212,24889,35531,35303,6192,2605,363,516,49517,1304,784,2088,5151,2267,2884,25233,123,NA
50013,"Grand Isle County, Vermont",7335,3767,3568,48551,5608,1406,727,118,138,7327,180,112,292,544,277,267,3613,10,NA
50015,"Lamoille County, Vermont",25977,13023,12954,42778,18510,5040,2176,455,251,25875,982,645,1627,2177,1129,1048,13709,164,NA
50017,"Orange County, Vermont",29439,14820,14619,38709,21890,4186,2388,655,482,29349,888,431,1319,2662,1209,1453,15650,151,NA
50019,"Orleans County, Vermont",27459,13899,13560,34365,20080,3474,1608,346,141,26758,586,351,937,2610,1025,1585,13184,62,NA
50021,"Rutland County, Vermont",60585,30326,30259,36845,44836,8964,4513,863,474,60012,1855,850,2705,6677,2907,3770,28803,138,NA
50023,"Washington County, Vermont",59768,29775,29993,43002,43551,11793,6147,1476,694,59143,1117,598,1715,5703,2787,2916,30906,173,NA
50025,"Windham County, Vermont",45857,22648,23209,40284,34055,7225,4827,898,807,45559,1259,606,1865,5563,2491,3072,22579,155,NA
50027,"Windsor County, Vermont",57832,28520,29312,43180,43448,10459,5272,1159,819,57085,1589,1292,2881,4973,2148,2825,28757,229,0
51001,"Accomack County, Virginia",33367,16257,17110,31570,24396,2970,1747,334,157,32858,2046,1474,3520,5240,2289,2951,14099,277,NA
51003,"Albemarle County, Virginia",112513,54068,58445,55347,76936,23136,14590,4208,4328,111091,3556,2867,6423,7378,2897,4481,53838,447,0
51005,"Alleghany County, Virginia",15159,7501,7658,30143,11161,967,461,111,162,14866,603,503,1106,2035,860,1175,6007,27,NA
51007,"Amelia County, Virginia",13309,6531,6778,34122,9801,1251,416,40,30,13208,381,361,742,1469,752,717,6079,92,NA
51009,"Amherst County, Virginia",31426,14973,16453,34137,22321,2996,1498,99,286,31172,1292,1122,2414,3452,1434,2018,14609,50,NA
51011,"Appomattox County, Virginia",16253,7910,8343,31654,11491,1626,546,29,14,16191,581,764,1345,2225,1028,1197,7614,107,NA
51013,"Arlington County, Virginia",235845,119030,116815,85221,173124,61741,48347,14799,8003,231023,6803,5808,12611,15527,6906,8621,148246,1580,NA
51015,"Augusta County, Virginia",77433,39547,37886,35582,57106,8937,3193,730,421,73731,2874,2153,5027,5981,2332,3649,37136,51,NA
51017,"Bath County, Virginia",4177,2073,2104,33856,3217,408,154,17,11,4069,100,91,191,956,610,346,1722,12,NA
51019,"Bedford County, Virginia",79761,39452,40309,40552,58099,11560,5532,1009,814,79281,2420,2435,4855,7161,3263,3898,36473,359,NA
51021,"Bland County, Virginia",6241,3540,2701,27904,4995,565,201,42,12,5299,155,99,254,564,260,304,2277,19,NA
51023,"Botetourt County, Virginia",33734,16820,16914,40289,24891,4273,2024,361,225,33301,845,751,1596,2397,1035,1362,15827,170,NA
51025,"Brunswick County, Virginia",15965,8513,7452,26491,12066,1194,595,120,27,13855,576,512,1088,2346,828,1518,6248,305,NA
51027,"Buchanan County, Virginia",20246,10504,9742,24126,15445,853,777,43,16,19318,702,689,1391,4878,2565,2313,5805,106,NA
51029,"Buckingham County, Virginia",16869,9405,7464,27139,12595,985,447,46,53,14913,990,651,1641,2083,814,1269,6479,233,NA
51031,"Campbell County, Virginia",55518,27091,28427,31877,40012,6576,2824,198,264,54915,2026,1557,3583,5460,2389,3071,25668,284,NA
51033,"Caroline County, Virginia",31181,15457,15724,38432,21511,2961,1334,195,309,29785,1214,777,1991,3435,1548,1887,15767,63,NA
51035,"Carroll County, Virginia",29126,14335,14791,27972,21867,2474,737,132,134,28971,1385,1249,2634,4411,2226,2185,12029,38,NA
51036,"Charles City County, Virginia",6760,3362,3398,38351,5323,628,168,23,43,6741,290,137,427,836,427,409,3222,70,NA
51037,"Charlotte County, Virginia",11563,5865,5698,27159,8154,789,475,88,4,11424,709,308,1017,2304,1050,1254,4537,114,NA
51041,"Chesterfield County, Virginia",366019,177338,188681,45041,247120,64038,31571,4918,4057,363003,14346,12011,26357,24163,10569,13594,184760,1260,NA
51043,"Clarke County, Virginia",14882,7353,7529,50751,10904,2420,920,266,155,14600,576,297,873,789,368,421,7421,98,NA
51045,"Craig County, Virginia",4898,2446,2452,32020,3476,378,148,0,29,4872,41,100,141,518,239,279,1964,0,NA
51047,"Culpeper County, Virginia",52822,26404,26418,39062,35453,6226,2602,305,385,51409,2713,2108,4821,3752,1592,2160,25422,240,0
51049,"Cumberland County, Virginia",9697,4887,4810,38099,7215,705,526,44,62,9697,421,411,832,770,381,389,4917,26,NA
51051,"Dickenson County, Virginia",14089,7165,6924,25003,10379,970,168,29,19,13626,415,391,806,3062,1324,1738,4444,66,NA
51053,"Dinwiddie County, Virginia",28057,14111,13946,35506,20159,2227,995,211,166,27625,1184,642,1826,3014,1254,1760,13371,2,NA
51057,"Essex County, Virginia",10602,4988,5614,29021,7710,779,318,42,42,10504,575,439,1014,1797,750,1047,4073,107,NA
51059,"Fairfax County, Virginia",1145354,573140,572214,67598,782543,248678,185979,39763,27229,1130306,46044,38834,84878,67901,30160,37741,611718,6869,7
51061,"Fauquier County, Virginia",73290,36589,36701,54878,50357,12142,5486,1224,1002,72976,3021,2615,5636,4241,2004,2237,38097,353,NA
51063,"Floyd County, Virginia",15532,7649,7883,31788,11686,1588,798,154,171,15414,691,436,1127,1453,720,733,7584,0,NA
51065,"Fluvanna County, Virginia",27442,12811,14631,48426,20240,4547,2016,183,498,26156,1298,801,2099,1561,871,690,13164,231,NA
51067,"Franklin County, Virginia",54838,27147,27691,37329,39873,6109,2602,448,349,54491,1983,1933,3916,7046,3331,3715,23512,207,NA
51069,"Frederick County, Virginia",92007,46279,45728,43375,64068,10918,5958,1143,619,90496,4140,3065,7205,6114,2819,3295,44501,361,NA
51071,"Giles County, Virginia",16711,8254,8457,31917,12132,1376,689,105,166,16565,753,309,1062,1596,630,966,7406,66,NA
51073,"Gloucester County, Virginia",38875,19309,19566,39450,28272,4511,2184,254,260,38202,1104,787,1891,2846,1095,1751,19083,184,NA
51075,"Goochland County, Virginia",24906,12404,12502,63645,18847,4704,2452,727,492,23910,586,280,866,1009,335,674,11326,41,NA
51077,"Grayson County, Virginia",15356,8064,7292,26270,11769,1216,352,51,41,14470,836,640,1476,2700,1178,1522,5827,138,NA
51079,"Greene County, Virginia",20631,9860,10771,39180,14314,2476,1159,61,296,20479,756,626,1382,2273,932,1341,10557,145,NA
51081,"Greensville County, Virginia",11373,6951,4422,22437,8609,751,300,41,64,8427,461,199,660,1090,518,572,3877,267,NA
51083,"Halifax County, Virginia",34013,16334,17679,26440,24647,2798,1060,202,151,33070,1772,1009,2781,4867,1919,2948,13505,337,NA
51085,"Hanover County, Virginia",110513,54636,55877,49110,76949,20372,8834,1794,1197,109812,2534,2021,4555,5620,2587,3033,56934,466,NA
51087,"Henrico County, Virginia",333120,159152,173968,47865,232800,62157,31376,7174,4950,330140,12066,8813,20879,27770,11988,15782,173906,1921,NA
51089,"Henry County, Virginia",50760,24420,26340,26097,37373,3474,1698,159,49,49919,2384,1658,4042,8035,3343,4692,19464,246,NA
51091,"Highland County, Virginia",2247,1034,1213,32704,1716,346,132,25,23,2247,63,118,181,230,146,84,805,5,NA
51093,"Isle of Wight County, Virginia",38898,19422,19476,45230,27889,4938,2536,441,391,38193,1282,1057,2339,3771,1369,2402,18470,92,NA
51095,"James City County, Virginia",78818,38132,40686,50984,57505,15086,9721,1921,2034,76853,2367,1623,3990,5675,2532,3143,35330,221,NA
51097,"King and Queen County, Virginia",6681,3485,3196,38904,5203,873,224,16,61,6681,343,116,459,1330,595,735,3248,11,NA
51099,"King George County, Virginia",26985,13719,13266,44551,17979,3694,2122,120,331,26423,516,488,1004,1846,700,1146,13820,69,NA
51101,"King William County, Virginia",17845,8842,9003,36145,12367,2299,616,153,0,17776,409,627,1036,1420,730,690,9155,14,NA
51103,"Lancaster County, Virginia",10866,5325,5541,46405,8739,1598,637,350,238,10609,442,300,742,1489,568,921,3953,87,NA
51105,"Lee County, Virginia",22287,11812,10475,23257,16643,1408,378,73,58,20843,1214,1032,2246,5380,2475,2905,6901,62,NA
51107,"Loudoun County, Virginia",420773,210848,209925,67251,272771,97356,60957,9175,5733,418514,11659,10440,22099,15706,6251,9455,226387,2028,6
51109,"Louisa County, Virginia",38106,19078,19028,40803,27905,4102,2489,390,228,37982,1736,958,2694,4120,1760,2360,17615,129,NA
51111,"Lunenburg County, Virginia",11988,6285,5703,26486,8799,654,276,30,17,11104,646,560,1206,1445,608,837,4556,61,NA
51113,"Madison County, Virginia",13828,6764,7064,35772,10115,1288,855,211,124,13687,407,366,773,1083,646,437,6470,54,NA
51115,"Mathews County, Virginia",8537,4124,4413,48173,6472,1402,419,84,24,8442,493,220,713,578,344,234,3172,13,NA
51117,"Mecklenburg County, Virginia",30367,15032,15335,31010,22650,2959,1654,183,67,29423,1410,767,2177,5508,2366,3142,12273,489,NA
51119,"Middlesex County, Virginia",10738,5360,5378,39111,8382,1679,588,93,120,10406,425,244,669,990,371,619,4437,69,NA
51121,"Montgomery County, Virginia",99373,51542,47831,32776,55915,12154,8640,1474,3742,98726,2856,2340,5196,22144,11310,10834,45188,590,0
51125,"Nelson County, Virginia",14773,7463,7310,42837,11116,2024,926,170,263,14732,823,446,1269,1950,1040,910,6495,92,NA
51127,"New Kent County, Virginia",23296,12186,11110,49666,17446,4110,1465,58,230,22563,502,332,834,889,316,573,12083,90,NA
51131,"Northampton County, Virginia",12132,5722,6410,37321,9104,1593,759,184,135,11862,672,550,1222,1983,892,1091,4850,13,NA
51133,"Northumberland County, Virginia",12007,5555,6452,45156,9305,1757,1053,166,163,12007,355,560,915,1767,704,1063,4336,38,NA
51135,"Nottoway County, Virginia",15638,8295,7343,27223,11219,1308,330,93,70,13902,1352,520,1872,2652,1302,1350,5833,278,NA
51137,"Orange County, Virginia",36593,18178,18415,41650,26211,4377,2185,428,166,36002,1244,1005,2249,4670,1939,2731,17338,137,NA
51139,"Page County, Virginia",23753,11987,11766,30146,17364,1419,885,146,102,23520,1392,1153,2545,2361,1083,1278,10681,96,NA
51141,"Patrick County, Virginia",17660,8930,8730,32883,13562,1530,545,54,79,17240,619,454,1073,1964,855,1109,7210,70,NA
51143,"Pittsylvania County, Virginia",60541,30142,30399,28428,44958,4666,1738,188,146,59282,2620,1361,3981,9714,4347,5367,25257,445,NA
51145,"Powhatan County, Virginia",30503,16003,14500,47268,22976,5397,1688,367,74,28861,598,491,1089,1305,652,653,15147,45,NA
51147,"Prince Edward County, Virginia",21922,11433,10489,25205,12652,2077,968,89,270,20650,707,728,1435,2988,1246,1742,8237,199,NA
51149,"Prince George County, Virginia",42634,23947,18687,31801,27630,4623,1522,303,209,35208,913,502,1415,3040,1440,1600,19827,224,NA
51153,"Prince William County, Virginia",481114,242456,238658,48958,308899,79259,45133,5377,5138,473108,26766,22444,49210,28768,12456,16312,249858,3225,0
51155,"Pulaski County, Virginia",33841,17127,16714,34870,25456,3222,1711,288,161,32718,1152,580,1732,4261,1893,2368,14880,180,NA
51157,"Rappahannock County, Virginia",7422,3746,3676,54654,5568,1030,598,137,118,7419,563,257,820,565,201,364,3468,34,NA
51159,"Richmond County, Virginia",8968,5035,3933,27620,6785,770,329,55,55,7361,253,205,458,556,344,212,3208,33,NA
51161,"Roanoke County, Virginia",96653,46725,49928,43125,69897,16855,6170,1803,1404,94727,2629,1755,4384,6665,2905,3760,46477,251,NA
51163,"Rockbridge County, Virginia",22673,11175,11498,37087,17030,2660,1724,397,356,22432,752,632,1384,1983,1113,870,9969,40,NA
51165,"Rockingham County, Virginia",83905,41490,42415,37180,57436,9785,4790,782,1199,83431,4245,3078,7323,7161,3272,3889,41338,250,NA
51167,"Russell County, Virginia",25763,12869,12894,25939,19105,1641,539,57,161,25523,813,727,1540,4925,2402,2523,8527,101,NA
51169,"Scott County, Virginia",21536,10954,10582,26681,16157,1470,707,38,28,20756,825,635,1460,3523,1590,1933,7808,70,NA
51171,"Shenandoah County, Virginia",44337,21907,22430,34170,31621,3848,2143,319,231,43950,1663,1162,2825,5504,2023,3481,20387,252,NA
51173,"Smyth County, Virginia",29799,14783,15016,26660,21792,2431,1085,162,125,29131,1273,778,2051,5460,2484,2976,11673,89,NA
51175,"Southampton County, Virginia",18003,9450,8553,32218,13236,1701,593,149,67,16614,494,510,1004,1384,547,837,7839,206,NA
51177,"Spotsylvania County, Virginia",141097,70013,71084,44881,94502,18959,9800,1498,1204,140084,5908,4581,10489,10308,4367,5941,69708,329,NA
51179,"Stafford County, Virginia",157606,79848,77758,48971,101532,26284,14354,1693,1403,151789,6113,4519,10632,8268,3405,4863,78696,800,NA
51181,"Surry County, Virginia",6546,3285,3261,36497,4969,871,226,41,30,6536,214,239,453,870,346,524,3069,75,NA
51183,"Sussex County, Virginia",10866,6320,4546,28788,7976,779,364,37,48,9420,504,267,771,1198,523,675,4307,6,NA
51185,"Tazewell County, Virginia",40392,20128,20264,27327,29102,3126,1147,152,214,39103,1371,1096,2467,7035,2820,4215,14127,128,NA
51187,"Warren County, Virginia",40800,20570,20230,37706,28642,4225,1499,433,266,40475,2302,2014,4316,4771,2237,2534,19244,93,NA
51191,"Washington County, Virginia",53985,26961,27024,33900,40259,6328,2526,707,329,53240,2711,1550,4261,6303,2776,3527,23555,83,NA
51193,"Westmoreland County, Virginia",18480,8916,9564,35850,13910,1385,747,247,75,18247,753,820,1573,2935,1328,1607,7028,18,NA
51195,"Wise County, Virginia",36105,18850,17255,23702,25997,2532,1322,285,91,33811,1578,1055,2633,6612,2942,3670,12211,18,NA
51197,"Wythe County, Virginia",28275,13968,14307,31810,20773,2502,1297,123,253,28103,927,766,1693,4811,2326,2485,12341,94,NA
51199,"York County, Virginia",70238,34866,35372,47722,47433,12821,8105,1126,1422,65911,1430,1184,2614,3262,1406,1856,35523,181,NA
51510,"Alexandria city, Virginia",157594,76589,81005,75884,119669,37901,28147,8438,4496,153544,6570,6903,13473,13760,6140,7620,97901,761,0
51520,"Bristol city, Virginia",17036,8213,8823,30419,12294,1447,923,221,213,16819,1416,884,2300,2840,1288,1552,7286,15,NA
51530,"Buena Vista city, Virginia",6639,3128,3511,32925,4024,528,240,11,85,6552,285,136,421,1334,443,891,3056,53,NA
51540,"Charlottesville city, Virginia",46289,22528,23761,45625,29416,8241,5104,1715,2279,45914,1426,1451,2877,10254,4742,5512,23670,111,NA
51550,"Chesapeake city, Virginia",249377,122672,126705,42753,168224,37311,17523,3483,1843,237016,8481,7370,15851,18669,8142,10527,123540,1272,0
51570,"Colonial Heights city, Virginia",18158,8304,9854,37039,12713,2148,1148,158,116,17890,669,637,1306,1826,696,1130,8540,214,NA
51580,"Covington city, Virginia",5722,2716,3006,24657,3991,296,129,30,0,5634,269,206,475,951,388,563,2332,0,NA
51590,"Danville city, Virginia",42507,19496,23011,26453,29469,3421,1517,387,171,41315,2258,1494,3752,10350,4455,5895,16076,148,NA
51595,"Emporia city, Virginia",5680,2531,3149,24915,3819,367,160,55,47,5464,86,172,258,939,274,665,2176,53,0
51600,"Fairfax city, Virginia",24242,11945,12297,59688,16324,5065,3115,719,904,23700,702,801,1503,2337,890,1447,12943,110,NA
51610,"Falls Church city, Virginia",14576,7274,7302,83001,9712,2969,3165,1084,442,14417,26,109,135,338,66,272,7948,100,NA
51620,"Franklin city, Virginia",8194,3921,4273,29683,5659,737,432,59,84,8075,176,71,247,1506,676,830,3367,175,NA
51630,"Fredericksburg city, Virginia",28258,13202,15056,43063,16897,4208,2438,422,278,28089,1378,1007,2385,4667,2287,2380,14354,176,NA
51640,"Galax city, Virginia",6687,2976,3711,29802,4432,453,289,16,16,6439,375,553,928,1434,480,954,2796,39,NA
51650,"Hampton city, Virginia",137217,66248,70969,35002,92527,15565,7729,1123,1185,130075,4887,4346,9233,17890,7334,10556,67348,776,NA
51660,"Harrisonburg city, Virginia",51784,25035,26749,25881,26275,5194,2878,494,681,51164,2998,2422,5420,12123,5602,6521,23583,107,NA
51670,"Hopewell city, Virginia",23046,10827,12219,25664,15006,1097,425,86,58,22648,932,636,1568,4867,2176,2691,9431,17,NA
51678,"Lexington city, Virginia",7346,4285,3061,29117,3367,1040,460,95,433,7270,98,56,154,696,397,299,2721,11,NA
51680,"Lynchburg city, Virginia",79166,36991,42175,28478,44182,10012,4746,911,1113,77289,2934,2371,5305,12033,5227,6806,36027,845,NA
51683,"Manassas city, Virginia",42620,21632,20988,42958,27688,6081,2847,443,192,42541,4562,3818,8380,2014,840,1174,22588,135,NA
51685,"Manassas Park city, Virginia",17123,8685,8438,41595,11381,1941,806,56,44,17123,1621,1660,3281,863,545,318,9756,82,NA
51690,"Martinsville city, Virginia",13539,6349,7190,27052,8927,1137,510,114,51,13105,753,612,1365,3217,1641,1576,5308,156,NA
51700,"Newport News city, Virginia",185118,90193,94925,36135,120199,21039,10470,1463,1498,174829,7920,7067,14987,26056,11054,15002,92115,854,0
51710,"Norfolk city, Virginia",236973,120733,116240,35761,152314,29179,13953,3661,2202,209694,12807,8259,21066,36342,15418,20924,125430,1546,NA
51720,"Norton city, Virginia",3668,1692,1976,27666,2684,293,205,13,9,3604,244,136,380,1049,456,593,1466,24,NA
51730,"Petersburg city, Virginia",33261,15163,18098,28146,22903,3094,1594,120,176,32490,2065,1417,3482,7275,3111,4164,14304,281,NA
51735,"Poquoson city, Virginia",12479,6277,6202,47329,8747,1809,1152,291,111,12262,77,199,276,560,300,260,6350,37,NA
51740,"Portsmouth city, Virginia",97384,46879,50505,31457,65575,8863,3976,618,476,91700,3915,3108,7023,16331,5952,10379,45028,1062,NA
51750,"Radford city, Virginia",16379,7411,8968,24835,7321,1565,1196,161,356,16214,511,384,895,4501,1923,2578,7771,118,NA
51760,"Richmond city, Virginia",227171,108032,119139,42132,160905,41357,19960,5892,3790,224604,12712,8938,21650,42324,18067,24257,119758,1146,NA
51770,"Roanoke city, Virginia",99213,46791,52422,33206,69643,12316,4647,1773,1050,97799,6029,3472,9501,18635,8364,10271,46368,541,NA
51775,"Salem city, Virginia",25372,12187,13185,37991,17311,3331,1721,307,271,24393,703,783,1486,2186,826,1360,12358,37,NA
51790,"Staunton city, Virginia",25581,11715,13866,34581,18357,3406,1865,407,483,24931,1239,809,2048,2763,1256,1507,12047,43,NA
51800,"Suffolk city, Virginia",94856,46381,48475,44004,64647,12702,6138,1014,886,91679,2703,2857,5560,8868,3724,5144,45875,355,NA
51810,"Virginia Beach city, Virginia",457900,225616,232284,45320,316178,78171,35380,7130,5109,433386,16155,13638,29793,36085,15413,20672,242547,2789,NA
51820,"Waynesboro city, Virginia",22341,10995,11346,30380,15799,2595,1174,274,257,22118,1248,888,2136,3562,1461,2101,10864,99,NA
51830,"Williamsburg city, Virginia",15486,7277,8209,35264,7688,2068,1120,297,406,15206,521,389,910,1451,705,746,6444,81,NA
51840,"Winchester city, Virginia",28103,13874,14229,36012,18799,3562,1851,416,236,27780,2120,1204,3324,4539,2317,2222,14308,99,0
53001,"Adams County, Washington",20557,10509,10048,24609,11258,1018,477,90,72,20340,1808,1528,3336,4251,2001,2250,8050,159,NA
53003,"Asotin County, Washington",22370,11031,11339,36800,16165,2321,946,357,110,22165,912,591,1503,3564,1535,2029,9300,20,NA
53005,"Benton County, Washington",207560,104632,102928,39668,134954,26629,11869,2176,2968,206256,9626,6882,16508,21647,10061,11586,92769,344,NA
53007,"Chelan County, Washington",79076,39895,39181,39746,54434,10471,3914,1212,479,78363,5129,3426,8555,7212,3173,4039,36824,934,NA
53009,"Clallam County, Washington",77333,38422,38911,38181,59865,10921,5366,1434,731,76028,3286,2406,5692,8289,4190,4099,29996,311,NA
53011,"Clark County, Washington",504091,250981,253110,43872,345411,70887,29501,6635,4164,501549,17143,14876,32019,44315,19410,24905,237782,2588,0
53013,"Columbia County, Washington",3980,1962,2018,40774,3021,483,213,43,66,3941,150,163,313,367,193,174,1743,19,NA
53015,"Cowlitz County, Washington",110621,55417,55204,35526,77072,8679,3194,524,392,109773,3842,2762,6604,13253,6121,7132,45906,595,NA
53017,"Douglas County, Washington",43189,22349,20840,39867,28706,4466,1253,278,240,43063,3253,1932,5185,3402,1391,2011,20326,699,NA
53019,"Ferry County, Washington",7260,3645,3615,31355,5559,644,271,51,41,7195,242,126,368,1114,609,505,2460,33,NA
53021,"Franklin County, Washington",96692,49955,46737,31346,56267,6915,3403,477,480,94698,6777,6077,12854,12619,5800,6819,42094,510,NA
53023,"Garfield County, Washington",2310,1174,1136,31187,1696,269,170,13,6,2283,78,17,95,254,119,135,862,0,NA
53025,"Grant County, Washington",99145,50580,48565,29655,60723,7832,2254,447,196,98716,6842,5328,12170,14019,6665,7354,42635,470,NA
53027,"Grays Harbor County, Washington",75672,39090,36582,31703,55194,6104,2610,490,277,72822,3098,1967,5065,10806,5130,5676,28624,220,NA
53029,"Island County, Washington",86510,43409,43101,44217,63659,13324,6815,1475,896,78904,2042,1485,3527,5725,2345,3380,38999,206,0
53031,"Jefferson County, Washington",33006,16189,16817,44289,27822,6616,3675,1052,748,32368,897,671,1568,4473,1911,2562,11478,48,NA
53033,"King County, Washington",2254371,1143593,1110778,66811,1622636,519110,267894,56443,46502,2240808,68288,50698,118986,187794,85634,102160,1212908,11278,15
53035,"Kitsap County, Washington",275411,141665,133746,47713,194382,44914,17325,4327,2108,259735,7526,5826,13352,22101,9875,12226,131017,1320,0
53037,"Kittitas County, Washington",44424,22385,22039,39399,28306,6515,2436,632,623,44196,1620,742,2362,6121,2340,3781,21580,234,NA
53039,"Klickitat County, Washington",22798,11635,11163,38760,17119,2950,1574,391,356,22764,1120,570,1690,3132,1375,1757,9249,273,NA
53041,"Lewis County, Washington",82663,41896,40767,32800,58732,7495,3342,540,227,81905,3067,2187,5254,10018,4527,5491,33406,219,NA
53043,"Lincoln County, Washington",11036,5587,5449,36741,7879,1207,483,108,15,10907,228,175,403,1269,638,631,4418,37,NA
53045,"Mason County, Washington",66053,34458,31595,37088,48525,6510,2879,747,269,64810,2687,1557,4244,8387,3945,4442,25535,229,NA
53047,"Okanogan County, Washington",42336,21632,20704,29777,29871,4140,1888,345,391,41758,3285,2054,5339,7853,3930,3923,17501,295,NA
53049,"Pacific County, Washington",23396,11714,11682,36899,18446,3112,954,138,170,23174,672,560,1232,3022,1455,1567,8482,95,NA
53051,"Pend Oreille County, Washington",13570,7057,6513,33981,9958,1409,598,88,45,13463,450,427,877,1730,907,823,4806,51,NA
53053,"Pierce County, Washington",918993,462489,456504,43575,622204,117242,47157,11963,6045,891656,29796,24025,53821,77932,35280,42652,446913,3814,5
53055,"San Juan County, Washington",18001,8850,9151,59650,14820,4463,2171,601,560,17924,730,618,1348,1954,807,1147,8106,146,0
53057,"Skagit County, Washington",129480,64614,64866,41191,92028,16556,7203,1747,882,127473,4831,3787,8618,15305,6816,8489,57119,332,NA
53059,"Skamania County, Washington",12118,5996,6122,42162,9148,1457,635,188,131,12068,312,320,632,1036,446,590,5511,30,NA
53061,"Snohomish County, Washington",828337,418342,409995,49215,580338,135876,53933,8605,6825,818836,28041,22743,50784,62171,27662,34509,418564,3415,0
53063,"Spokane County, Washington",538711,269376,269335,38052,371538,76236,30159,7553,4686,529135,16257,11013,27270,64591,29510,35081,246816,1988,0
53065,"Stevens County, Washington",46774,23444,23330,32904,33841,4341,1880,517,350,46571,1825,1604,3429,6161,2903,3258,17576,233,NA
53067,"Thurston County, Washington",294272,145124,149148,42306,208615,47084,21219,4856,2787,286433,8494,5901,14395,27142,12040,15102,137214,1348,NA
53069,"Wahkiakum County, Washington",4476,2276,2200,31643,3451,506,189,47,22,4440,79,114,193,609,297,312,1550,77,NA
53071,"Walla Walla County, Washington",62150,31276,30874,34476,40947,6937,3575,920,800,59421,2690,2193,4883,6396,2575,3821,26947,176,NA
53073,"Whatcom County, Washington",226523,112654,113869,40916,152506,34017,15287,3365,3782,224896,7476,5863,13339,28469,13264,15205,109391,1033,0
53075,"Whitman County, Washington",47141,23954,23187,30287,24342,6581,3413,621,1777,46813,1236,884,2120,9796,4997,4799,22363,233,NA
53077,"Yakima County, Washington",256143,128661,127482,27448,155876,18200,7574,1724,868,253882,18333,15453,33786,39239,18207,21032,105896,852,NA
54001,"Barbour County, West Virginia",15527,7620,7907,24947,10601,729,390,94,35,15360,414,433,847,3278,1374,1904,5578,219,NA
54003,"Berkeley County, West Virginia",123283,61697,61586,35909,85192,13653,5677,845,543,122448,4255,3295,7550,13305,5382,7923,61078,521,NA
54005,"Boone County, West Virginia",21705,10931,10774,26242,15480,990,685,36,95,21516,799,459,1258,3543,1635,1908,7010,65,NA
54007,"Braxton County, West Virginia",12505,6406,6099,21948,9292,801,248,37,5,12066,578,590,1168,2196,910,1286,3730,221,NA
54009,"Brooke County, West Virginia",22349,11092,11257,30400,16252,2242,1105,99,113,22117,847,342,1189,2353,795,1558,9282,56,NA
54011,"Cabell County, West Virginia",93965,45862,48103,30068,62754,10541,5704,1447,1324,92099,3671,3204,6875,18063,8251,9812,39546,450,NA
54013,"Calhoun County, West Virginia",6279,3004,3275,22982,4718,245,87,60,1,6253,234,337,571,2103,985,1118,1794,0,NA
54015,"Clay County, West Virginia",8049,4017,4032,23264,5609,366,235,4,102,7991,212,185,397,1947,834,1113,2519,3,NA
54017,"Doddridge County, West Virginia",7847,4475,3372,29652,6056,549,94,84,0,6750,350,201,551,974,476,498,2927,39,NA
54019,"Fayette County, West Virginia",40545,20365,20180,24818,29452,3175,1280,121,76,39334,1772,1383,3155,8388,4017,4371,13818,237,NA
54021,"Gilmer County, West Virginia",7444,4491,2953,20653,5288,624,362,21,62,5921,309,150,459,614,266,348,2245,74,NA
54023,"Grant County, West Virginia",11034,5564,5470,28274,8164,681,342,6,50,10918,541,391,932,1280,665,615,4973,67,NA
54025,"Greenbrier County, West Virginia",32995,16010,16985,29992,24403,2975,1317,412,395,32407,1190,1121,2311,6434,2724,3710,13148,66,NA
54027,"Hampshire County, West Virginia",23275,11985,11290,28713,17297,1681,652,138,47,22775,1873,889,2762,3941,1908,2033,8516,22,NA
54029,"Hancock County, West Virginia",28907,14208,14699,34257,21485,2859,870,304,69,28607,1426,1210,2636,3814,1636,2178,12409,262,NA
54031,"Hardy County, West Virginia",14249,7457,6792,30667,10431,782,663,66,43,14188,609,129,738,2446,1243,1203,6157,81,NA
54033,"Harrison County, West Virginia",65862,32548,33314,32658,46803,6934,3480,794,336,65056,2581,1971,4552,8830,3793,5037,28346,217,NA
54035,"Jackson County, West Virginia",27868,13896,13972,34014,19840,2400,889,100,306,27666,812,799,1611,5415,2542,2873,10149,22,NA
54037,"Jefferson County, West Virginia",58043,28953,29090,42359,40367,8119,3608,769,492,57771,2077,1288,3365,5153,2135,3018,27856,419,NA
54039,"Kanawha County, West Virginia",179895,87343,92552,34976,130252,21682,9518,3864,1625,177624,5638,3769,9407,29058,13310,15748,76292,557,0
54041,"Lewis County, West Virginia",16920,8494,8426,31444,12133,1338,521,135,142,16736,673,340,1013,2812,1234,1578,6537,483,NA
54043,"Lincoln County, West Virginia",20410,10127,10283,26713,14448,765,302,51,49,20340,532,387,919,3876,1871,2005,6418,3,NA
54045,"Logan County, West Virginia",32350,16054,16296,26111,23284,1638,1027,381,44,31656,1236,1076,2312,7481,3595,3886,9181,54,NA
54047,"McDowell County, West Virginia",18911,9428,9483,15353,13790,666,187,64,0,16999,511,716,1227,5653,2357,3296,3175,53,NA
54049,"Marion County, West Virginia",56194,28068,28126,31740,38618,6088,2933,319,341,55746,2266,1728,3994,8172,3848,4324,24828,265,NA
54051,"Marshall County, West Virginia",30509,15540,14969,33673,22710,2793,1152,279,100,29870,939,979,1918,4354,1852,2502,12888,90,NA
54053,"Mason County, West Virginia",25488,12579,12909,31085,18410,1919,664,76,190,24773,861,724,1585,4023,1731,2292,9091,51,NA
54055,"Mercer County, West Virginia",59530,28719,30811,27245,42048,5675,2400,295,281,59036,1911,1889,3800,10869,4953,5916,22693,173,NA
54057,"Mineral County, West Virginia",26957,13393,13564,33580,19384,2356,1857,98,159,26737,838,607,1445,3631,1376,2255,11553,30,NA
54059,"Mingo County, West Virginia",23466,11577,11889,21342,16663,935,570,79,9,23385,956,711,1667,6679,2744,3935,6017,14,NA
54061,"Monongalia County, West Virginia",105988,54753,51235,38757,65027,14220,10416,3058,3697,104740,3516,2064,5580,20594,10105,10489,53500,533,NA
54063,"Monroe County, West Virginia",12438,6210,6228,26120,8964,877,375,55,58,12369,756,620,1376,1628,731,897,4208,30,NA
54065,"Morgan County, West Virginia",17237,8783,8454,33029,13060,1296,845,204,97,17089,820,427,1247,1808,991,817,7721,46,NA
54067,"Nicholas County, West Virginia",24624,12465,12159,27744,17841,1646,1300,224,118,24473,772,553,1325,4081,1724,2357,9044,83,NA
54069,"Ohio County, West Virginia",42224,20497,21727,36191,29835,6073,2615,754,457,41709,1151,783,1934,5875,2444,3431,18314,110,NA
54071,"Pendleton County, West Virginia",6156,3178,2978,27513,4653,674,167,37,17,6063,300,132,432,989,529,460,2432,0,NA
54073,"Pleasants County, West Virginia",7622,4269,3353,39138,5430,342,292,13,8,7028,477,164,641,542,285,257,2989,8,NA
54075,"Pocahontas County, West Virginia",7940,4133,3807,23736,5994,512,349,17,7,7602,272,140,412,1540,707,833,2486,56,NA
54077,"Preston County, West Virginia",34206,18139,16067,27848,25566,2866,1363,69,193,30732,1027,1000,2027,4205,1774,2431,13272,47,NA
54079,"Putnam County, West Virginia",57347,28611,28736,38589,40561,7241,3624,596,519,56655,1910,1102,3012,6229,2513,3716,25790,225,NA
54081,"Raleigh County, West Virginia",74303,37402,36901,27724,52795,6485,3308,656,401,71529,1983,1473,3456,15613,7101,8512,26338,191,NA
54083,"Randolph County, West Virginia",28005,14750,13255,26289,20533,2501,876,128,115,25960,1048,957,2005,3943,1560,2383,10436,433,NA
54085,"Ritchie County, West Virginia",8507,4288,4219,27997,6234,592,156,20,0,8462,351,249,600,1686,839,847,2859,24,NA
54087,"Roane County, West Virginia",14027,7016,7011,24849,10110,917,410,32,18,13928,636,312,948,2931,1407,1524,4125,6,NA
54089,"Summers County, West Virginia",11985,5650,6335,24507,9424,980,491,45,43,11113,393,237,630,2351,1088,1263,3356,30,NA
54091,"Taylor County, West Virginia",16602,8283,8319,30095,12187,1514,467,131,124,16175,447,465,912,2722,1469,1253,6456,59,NA
54093,"Tucker County, West Virginia",6747,3402,3345,32590,5388,738,456,94,50,6592,205,135,340,639,321,318,2972,0,NA
54095,"Tyler County, West Virginia",8336,4173,4163,29891,6182,685,312,11,5,8258,299,98,397,986,398,588,2925,39,NA
54097,"Upshur County, West Virginia",23875,12038,11837,28855,16418,1564,926,133,110,23609,748,868,1616,4009,1778,2231,9267,438,NA
54099,"Wayne County, West Virginia",38933,19098,19835,29774,28006,2872,1709,254,294,38806,1480,1540,3020,6490,2756,3734,13872,85,NA
54101,"Webster County, West Virginia",8362,4168,4194,23494,6181,549,126,14,22,8299,239,110,349,1477,757,720,2578,40,NA
54103,"Wetzel County, West Virginia",14431,7168,7263,27174,10305,940,336,44,65,14332,487,338,825,2397,1078,1319,5082,134,NA
54105,"Wirt County, West Virginia",5202,2560,2642,26966,3848,395,188,0,0,5202,116,76,192,1046,456,590,1949,18,NA
54107,"Wood County, West Virginia",84272,41185,43087,31932,60316,8131,3930,637,591,83489,3132,2496,5628,12257,5477,6780,35520,195,NA
54109,"Wyoming County, West Virginia",21237,10650,10587,22818,15447,947,630,146,42,21163,978,400,1378,5137,2350,2787,5972,87,NA
55001,"Adams County, Wisconsin",20730,11207,9523,32223,16596,1895,554,66,78,19918,736,427,1163,2890,1241,1649,7987,88,NA
55003,"Ashland County, Wisconsin",16041,8256,7785,31563,11136,1464,620,157,61,15816,562,464,1026,2563,1265,1298,7581,87,NA
55005,"Barron County, Wisconsin",46683,23605,23078,34146,33242,4654,1411,511,316,46152,2235,1173,3408,5401,2475,2926,22230,132,NA
55007,"Bayfield County, Wisconsin",16214,8299,7915,39449,12545,2627,1142,273,169,16109,525,415,940,1676,781,895,7301,78,NA
55009,"Brown County, Wisconsin",268393,134295,134098,39091,180495,40059,12796,2677,1751,265692,8371,6117,14488,25358,11283,14075,139271,778,0
55011,"Buffalo County, Wisconsin",13329,6755,6574,34866,9747,1470,465,85,27,13263,397,290,687,1088,386,702,6802,52,NA
55013,"Burnett County, Wisconsin",16561,8572,7989,36322,12836,1936,685,151,63,16474,620,552,1172,1911,902,1009,6800,87,NA
55015,"Calumet County, Wisconsin",52361,26565,25796,42110,36408,8314,2503,394,333,52223,945,550,1495,3052,1173,1879,28601,130,NA
55017,"Chippewa County, Wisconsin",66254,34577,31677,36180,47131,8001,2143,510,283,63848,1920,1595,3515,6318,2568,3750,32569,268,NA
55019,"Clark County, Wisconsin",34703,17683,17020,29589,21563,2056,580,149,43,34211,3792,3349,7141,4168,1901,2267,15788,155,NA
55021,"Columbia County, Wisconsin",58272,29998,28274,40144,41753,6969,2216,571,342,56850,1552,1337,2889,4266,1975,2291,30294,157,NA
55023,"Crawford County, Wisconsin",16123,8405,7718,32129,11782,1485,432,99,48,15413,761,477,1238,1900,923,977,7013,79,NA
55025,"Dane County, Wisconsin",559891,280540,279351,49280,370892,120419,51939,12278,15593,555855,12338,8130,20468,59287,27543,31744,314337,2275,0
55027,"Dodge County, Wisconsin",89032,46897,42135,35949,64480,8945,2761,528,385,85487,2199,1287,3486,6485,2806,3679,46378,215,NA
55029,"Door County, Wisconsin",30038,14848,15190,45367,23483,5399,2054,509,318,29788,707,498,1205,2573,1200,1373,14156,80,NA
55031,"Douglas County, Wisconsin",44092,22256,21836,35646,31727,6063,1885,428,255,43445,1187,1074,2261,4824,2026,2798,21745,166,0
55033,"Dunn County, Wisconsin",45221,22829,22392,34615,27990,5172,2108,227,488,44868,1353,953,2306,4581,2242,2339,23558,172,NA
55035,"Eau Claire County, Wisconsin",105697,52562,53135,38529,67365,15550,5702,1410,1165,105130,3937,2439,6376,12308,5454,6854,56723,237,NA
55037,"Florence County, Wisconsin",4574,2337,2237,36746,3607,609,139,50,14,4515,239,98,337,441,197,244,1902,0,NA
55039,"Fond du Lac County, Wisconsin",104027,51551,52476,36824,73005,10940,4073,781,488,102318,2449,1832,4281,8634,3803,4831,52489,351,NA
55041,"Forest County, Wisconsin",9239,4642,4597,30310,6785,850,200,15,3,9024,380,376,756,1257,585,672,3744,18,NA
55043,"Grant County, Wisconsin",51842,26948,24894,32097,32525,4873,2107,413,482,50751,2290,1678,3968,6679,3378,3301,25660,336,NA
55045,"Green County, Wisconsin",37066,18682,18384,40954,26479,4624,1567,432,301,36755,908,652,1560,2414,992,1422,19534,120,NA
55047,"Green Lake County, Wisconsin",19093,9640,9453,35222,13502,1965,774,207,82,18918,888,805,1693,2393,959,1434,8845,85,NA
55049,"Iowa County, Wisconsin",23766,12060,11706,39330,16888,3202,998,359,128,23605,482,244,726,1874,797,1077,12784,107,NA
55051,"Iron County, Wisconsin",6136,3115,3021,34669,4938,824,248,79,21,6029,221,153,374,628,241,387,2649,41,NA
55053,"Jackson County, Wisconsin",20958,11303,9655,32659,14912,1585,643,74,66,19863,896,593,1489,2513,1077,1436,9119,64,NA
55055,"Jefferson County, Wisconsin",85932,43406,42526,39035,59485,11621,3673,828,458,85501,2086,1784,3870,6326,2632,3694,46221,370,NA
55057,"Juneau County, Wisconsin",26695,14477,12218,31211,19700,2219,713,200,43,25488,1280,441,1721,3737,2237,1500,12034,201,NA
55059,"Kenosha County, Wisconsin",168693,83870,84823,38720,114537,21475,9313,1604,1301,167049,6001,4713,10714,18284,7989,10295,85204,813,0
55061,"Kewaunee County, Wisconsin",20570,10527,10043,38012,14666,2105,676,100,90,20459,477,375,852,1372,635,737,10700,30,NA
55063,"La Crosse County, Wisconsin",120216,59025,61191,39498,77996,17046,7424,2044,1446,119009,3476,2155,5631,13619,5903,7716,62724,383,NA
55065,"Lafayette County, Wisconsin",16716,8538,8178,33484,11369,1563,572,91,34,16632,899,748,1647,1744,797,947,8303,104,NA
55067,"Langlade County, Wisconsin",19512,9907,9605,32989,14333,1592,578,68,31,19331,605,390,995,2357,1064,1293,8688,56,NA
55069,"Lincoln County, Wisconsin",28402,14353,14049,35558,21396,2726,991,225,75,27922,876,455,1331,2888,1210,1678,13099,119,NA
55071,"Manitowoc County, Wisconsin",81242,40886,40356,35854,58590,9562,2831,832,307,80621,1965,1705,3670,8004,3039,4965,40326,161,NA
55073,"Marathon County, Wisconsin",137820,69713,68107,38886,96076,17895,5912,1542,636,136722,4939,3344,8283,11323,5231,6092,70785,522,NA
55075,"Marinette County, Wisconsin",41827,21241,20586,33952,31233,3792,1424,264,104,41288,1021,737,1758,3939,1688,2251,18739,132,NA
55077,"Marquette County, Wisconsin",15619,8034,7585,33291,11727,1232,370,60,33,15574,487,390,877,1616,759,857,6911,46,NA
55078,"Menominee County, Wisconsin",4279,2185,2094,24004,2488,307,130,34,0,4260,484,532,1016,850,427,423,1364,23,NA
55079,"Milwaukee County, Wisconsin",933063,454480,478583,35039,620640,130326,53778,12035,9197,925310,39078,28054,67132,162787,74876,87911,445979,2683,0
55081,"Monroe County, Wisconsin",46208,23692,22516,33256,31206,4317,1474,321,163,45448,2187,1983,4170,5259,2382,2877,21749,300,NA
55083,"Oconto County, Wisconsin",39048,20030,19018,37124,28774,3830,999,130,32,38750,803,787,1590,3181,1507,1674,18925,199,NA
55085,"Oneida County, Wisconsin",37799,19161,18638,40086,29073,4915,2188,535,235,37263,1206,645,1851,3552,1867,1685,16525,95,NA
55087,"Outagamie County, Wisconsin",190611,95875,94736,42923,130100,28991,9286,1800,977,189152,4809,3891,8700,12949,5890,7059,101029,632,NA
55089,"Ozaukee County, Wisconsin",91745,45566,46179,55948,64467,19850,7648,2818,1789,91262,1337,1011,2348,4036,1536,2500,48123,220,NA
55091,"Pepin County, Wisconsin",7363,3781,3582,38730,5276,888,254,49,13,7301,292,249,541,570,246,324,3533,48,NA
55093,"Pierce County, Wisconsin",42187,20984,21203,39439,26847,5592,1976,466,295,41840,838,683,1521,3885,1722,2163,22212,175,NA
55095,"Polk County, Wisconsin",45128,23028,22100,37674,32988,5217,1700,388,202,44695,1795,1110,2905,3709,1668,2041,21893,148,NA
55097,"Portage County, Wisconsin",70281,35832,34449,37990,45814,10749,3484,475,688,70068,2257,1346,3603,7011,3106,3905,36822,178,NA
55099,"Price County, Wisconsin",14066,7248,6818,33468,10709,1205,373,74,71,13909,487,339,826,1880,827,1053,6013,51,NA
55101,"Racine County, Wisconsin",197068,97957,99111,38288,135029,25327,9872,1672,936,192605,5846,4458,10304,21743,8962,12781,94221,1618,NA
55103,"Richland County, Wisconsin",17256,8600,8656,33382,12336,1693,522,205,39,17118,917,752,1669,2456,986,1470,7914,37,NA
55105,"Rock County, Wisconsin",163817,81542,82275,35594,112361,18465,7107,948,885,162668,5154,3761,8915,15851,7025,8826,80958,609,NA
55107,"Rusk County, Wisconsin",14179,7221,6958,31329,10386,1243,384,94,57,14036,603,360,963,1588,713,875,6111,41,NA
55109,"St. Croix County, Wisconsin",93752,47359,46393,45810,63874,16833,5726,923,650,93048,2050,1281,3331,5513,2499,3014,50444,478,NA
55111,"Sauk County, Wisconsin",65664,32918,32746,37431,46152,8152,2457,661,341,65020,2399,1895,4294,5573,2424,3149,33750,371,NA
55113,"Sawyer County, Wisconsin",18057,9371,8686,36167,13693,2348,1021,187,130,17724,780,509,1289,2333,1102,1231,7703,125,NA
55115,"Shawano County, Wisconsin",40848,20589,20259,34825,29299,3661,1311,194,158,40332,1229,1337,2566,4037,1645,2392,19602,183,0
55117,"Sheboygan County, Wisconsin",117741,59860,57881,37454,82149,14669,5723,882,611,115482,2639,2169,4808,8817,4049,4768,60282,363,NA
55119,"Taylor County, Wisconsin",19979,10203,9776,32874,13904,1581,493,77,50,19807,687,566,1253,1742,715,1027,9763,149,NA
55121,"Trempealeau County, Wisconsin",30679,15606,15073,34694,20775,2838,1075,108,66,30315,1270,1093,2363,2229,968,1261,15240,117,NA
55123,"Vernon County, Wisconsin",30811,15666,15145,32297,20660,3309,1325,237,153,30516,2167,2242,4409,4433,1938,2495,13711,283,NA
55125,"Vilas County, Wisconsin",23146,12045,11101,40136,18135,3433,1403,317,136,22964,1015,604,1619,2235,1244,991,10001,46,NA
55127,"Walworth County, Wisconsin",105127,52922,52205,40386,70518,14460,5496,1148,621,104452,3395,2886,6281,9786,4668,5118,54345,347,0
55129,"Washburn County, Wisconsin",16685,8400,8285,34396,12605,2045,636,136,96,16513,573,499,1072,2035,1041,994,7064,57,NA
55131,"Washington County, Wisconsin",136842,68585,68257,45821,97348,22631,8453,1099,858,136167,2769,1939,4708,6436,2783,3653,73600,366,NA
55133,"Waukesha County, Wisconsin",407290,202216,205074,55573,289847,90538,33328,8366,4497,404861,6880,5692,12572,19932,8207,11725,215530,1086,0
55135,"Waupaca County, Wisconsin",51822,26448,25374,39147,37712,5234,1668,295,138,50571,1547,1436,2983,4439,1968,2471,25573,275,NA
55137,"Waushara County, Wisconsin",24672,13129,11543,37927,18695,2121,713,171,81,23633,1112,870,1982,2701,1230,1471,10588,180,NA
55139,"Winnebago County, Wisconsin",171197,87117,84080,37983,116103,23496,7631,1629,1296,167050,4907,2924,7831,17725,8566,9159,88979,280,NA
55141,"Wood County, Wisconsin",74138,36742,37396,36712,52948,7590,2563,790,345,73621,2166,1486,3652,7697,3269,4428,35109,206,NA
56001,"Albany County, Wyoming",37525,19594,17931,34969,21101,6073,3629,540,1562,37324,1603,1307,2910,8060,3897,4163,20511,131,NA
56003,"Big Horn County, Wyoming",11690,6006,5684,29746,7954,1149,392,57,34,11420,856,754,1610,1271,486,785,4868,30,0
56005,"Campbell County, Wyoming",46857,24226,22631,39781,30249,4219,2013,242,155,46233,3469,2925,6394,4397,1848,2549,23900,123,NA
56007,"Carbon County, Wyoming",14609,7857,6752,33905,10146,1639,402,43,53,14003,1198,794,1992,1948,941,1007,6516,76,NA
56009,"Converse County, Wyoming",13729,7066,6663,37976,9500,1231,742,106,7,13649,797,582,1379,1499,690,809,6843,135,NA
56011,"Crook County, Wyoming",7258,3634,3624,33386,5065,1021,142,13,3,7195,237,259,496,455,165,290,3398,0,NA
56013,"Fremont County, Wyoming",39402,19959,19443,30414,26286,3990,1948,353,84,38800,3876,3651,7527,5322,2503,2819,16314,188,NA
56015,"Goshen County, Wyoming",12592,6594,5998,32693,8911,1374,542,66,154,11891,580,459,1039,1084,441,643,5734,209,NA
56017,"Hot Springs County, Wyoming",4616,2317,2299,33128,3308,682,191,22,39,4535,368,313,681,720,251,469,2008,17,NA
56019,"Johnson County, Wyoming",8536,4406,4130,37691,6336,1222,661,93,40,8407,483,488,971,1401,716,685,3948,0,NA
56021,"Laramie County, Wyoming",100316,51152,49164,41104,68410,13178,5764,1267,649,96765,4886,3465,8351,8831,4166,4665,50613,306,NA
56023,"Lincoln County, Wyoming",19794,10134,9660,38245,13207,2048,712,147,143,19693,1242,1179,2421,1387,541,846,9577,232,NA
56025,"Natrona County, Wyoming",79506,40147,39359,40346,53977,8817,4278,825,428,78487,4898,3797,8695,7120,2969,4151,40190,263,NA
56027,"Niobrara County, Wyoming",2460,1056,1404,29442,1882,334,34,1,8,2230,121,69,190,409,164,245,1083,8,NA
56029,"Park County, Wyoming",29878,14832,15046,37544,21506,4669,1457,428,491,29684,1775,1687,3462,2796,1171,1625,14351,110,NA
56031,"Platte County, Wyoming",8618,4406,4212,37756,6572,788,476,94,96,8477,884,658,1542,1008,593,415,3494,0,NA
56033,"Sheridan County, Wyoming",31176,15564,15612,39656,22046,4174,1987,510,412,30791,1700,1527,3227,2633,1078,1555,15372,82,NA
56035,"Sublette County, Wyoming",8801,4769,4032,54704,6184,1193,362,0,27,8773,585,328,913,706,417,289,4365,62,NA
56037,"Sweetwater County, Wyoming",42079,21793,20286,40268,27594,3413,1432,468,201,41759,2835,2240,5075,4833,2004,2829,20668,22,NA
56039,"Teton County, Wyoming",23346,12114,11232,76296,17873,6945,2859,546,426,23262,1618,1144,2762,1606,706,900,14567,180,0
56041,"Uinta County, Wyoming",20546,10446,10100,32955,13274,1796,531,127,82,20355,1194,1003,2197,1315,663,652,9468,39,NA
56043,"Washakie County, Wyoming",7725,4045,3680,32979,5521,732,335,86,14,7586,509,366,875,503,234,269,3828,95,NA
56045,"Weston County, Wyoming",6870,3718,3152,37067,4900,626,164,43,30,6507,615,543,1158,830,519,311,2939,0,NA
